about|about,auto,boat,bout,bat,but,out,tub
abroad|abroad,board,broad,arab,road,bad,bar,rod
absent|beast,base,bean,beat,best,east,neat,nest,seat,ban,bat,bet,eat,net,sea,set,tea,ten
abuse|abuse,base,bus,sea,sue,use
accent|accent,enact,neat,act,can,cat,eat,etc,net,tea,ten
accept|accept,pace,tape,act,apt,cap,cat,eat,etc,pat,pet,tap,tea
acres|scare,care,case,race,car,ear,era,sea
acting|giant,gain,gait,act,can,cat,tag
action|action,coat,coin,icon,into,act,can,cat,not
active|active,cave,cite,act,cat,eat,etc,ice,tea,tie,via
actor|actor,cart,coat,act,art,car,cat,rat
actors|actor,coast,cart,cast,coat,cost,soar,sort,star,act,art,car,cat,rat
acute|cute,act,cat,cue,cut,eat,etc,tea
adding|gain,add,aid,and,dad,dig,din,dna
adipex|aide,idea,aid,die,dip,pad,pie
admin|amid,damn,main,mind,aid,aim,and,dam,dim,din,dna,mad,man
admit|admit,amid,aid,aim,dam,dim,mad
adopt|adopt,atop,apt,dot,opt,pad,pat,pot,tap,top
adrian|drain,rain,aid,air,and,din,dna,rid
advert|trade,dare,dart,date,dear,rate,read,tear,art,ear,eat,era,rat,red,tea
advice|advice,caved,acid,aide,avid,cave,idea,vied,aid,die,ice,via
advise|advise,aside,aide,aids,avid,idea,save,side,vied,aid,die,sad,sea,via
adware|award,aware,area,dare,dear,draw,read,wear,ear,era,raw,red,war,wed
aerial|area,rail,real,air,ear,era,lie
affect|affect,face,fact,fate,act,cat,eat,etc,fat,tea
afford|afford,road,far,for,off,rod
afraid|afraid,fair,aid,air,far,rid
after|after,fare,fate,fear,fret,rate,tear,art,ear,eat,era,far,fat,rat,tea
agency|agency,cage,age,any,can,gay
agent|agent,gate,neat,age,eat,get,net,tag,tea,ten
agents|agent,stage,east,gate,neat,nest,seat,age,eat,gas,get,net,sea,set,tag,tea,ten
agree|agree,eager,gear,rage,age,ear,era
agreed|agreed,agree,eager,grade,raged,dare,dear,deer,drag,edge,gear,rage,read,age,ear,era,red
agrees|agree,eager,ease,gear,rage,rags,age,ear,era,gas,sea,see
aimed|aimed,media,aide,amid,idea,aid,aim,dam,die,dim,mad
albert|alter,bleat,later,table,able,bare,bear,beat,belt,late,rate,real,tale,tear,art,bar,bat,bet,ear,eat,era,lab,let,rat,tea
albums|album,balm,slam,bus,lab,sum
alert|alter,later,late,rate,real,tale,tear,art,ear,eat,era,let,rat,tea
alerts|alter,laser,later,least,stale,stare,steal,east,last,late,rate,real,rest,sale,salt,seal,seat,star,tale,tear,art,ear,eat,era,let,rat,sea,set,tea
alfred|flared,dare,deal,dear,fade,fare,fear,lead,leaf,read,real,ear,era,far,red
alien|alien,lain,lane,lean,line,nail,lie
allied|ideal,aide,deal,idea,lead,aid,all,die,ill,lid,lie
allows|sallow,allow,also,slow,wall,all,law,low
almost|almost,also,last,lost,lots,most,salt,slam,slot,lot
along|along,goal,loan,long,ago,log
alpine|alien,panel,plain,plane,lain,lane,lean,leap,line,nail,pain,pale,peal,pile,pine,plan,plea,lap,lie,lip,nip,pan,pen,pie,pin
alter|alter,later,late,rate,real,tale,tear,art,ear,eat,era,let,rat,tea
alumni|lain,mail,main,nail,aim,man
always|always,away,sway,law,lay,say,sly,way
amanda|damn,and,dam,dna,mad,man
amber|bare,beam,bear,ream,arm,bar,ear,era
ambien|beam,bean,main,mane,mean,mine,name,aim,ban,man
amend|damn,mane,mean,name,and,dam,dna,end,mad,man
amount|amount,mount,aunt,auto,man,not,nut,out
analog|along,goal,loan,long,ago,log
anchor|ranch,corn,horn,can,car,nor
andale|laden,deal,land,lane,lead,lean,lend,and,dna,end
andrea|arena,area,dare,dear,earn,near,read,and,dna,ear,end,era,red
andrew|wander,drawn,dare,dawn,dear,draw,earn,near,read,wane,warn,wear,and,dna,ear,end,era,new,raw,red,wan,war,wed
angel|angel,angle,gale,lane,lean,age,leg
angela|angel,angle,gale,lane,lean,age,leg
angels|angel,angle,gale,lane,lean,lens,sale,seal,age,gas,leg,sea
anger|anger,range,earn,gear,near,rage,age,ear,era
angle|angel,angle,gale,lane,lean,age,leg
angola|along,goal,loan,long,ago,log
animal|animal,lain,mail,main,nail,aim,man
anime|main,mane,mean,mine,name,aim,man
answer|answer,swear,earn,near,news,sewn,wane,warn,wear,ear,era,new,raw,sea,wan,war
apart|apart,part,prat,rapt,trap,apt,art,pat,rap,rat,tap
apnic|panic,pain,can,cap,nip,pan,pin
appeal|appeal,apple,leap,pale,peal,plea,lap
appear|appear,paper,area,rape,ear,era,per,rap
apple|apple,leap,pale,peal,plea,lap
april|pair,rail,air,lap,lip,rap,rip
arabic|arab,air,bar,cab,car,rib
arcade|raced,area,card,care,dare,dear,race,read,car,ear,era,red
arctic|cart,act,air,art,car,cat,rat
arena|arena,area,earn,near,ear,era
argue|argue,gear,rage,urge,age,ear,era
argued|argued,argue,grade,guard,raged,dare,dear,drag,drug,gear,rage,read,urge,age,due,dug,ear,era,red
arise|arise,raise,rise,air,ear,era,sea,sir
armed|armed,dream,dare,dear,read,ream,arm,dam,ear,era,mad,red
arnold|land,load,loan,lord,oral,road,and,dna,nod,nor,old,rod
around|around,round,road,and,dna,nod,nor,our,rod,run
arrest|arrest,stare,east,rare,rate,rear,rest,seat,star,tear,art,ear,eat,era,rat,sea,set,tea
arrive|arrive,river,rare,rear,air,ear,era,via
artist|artist,stair,start,trait,star,stir,air,art,its,rat,sir,sit
ashley|easy,heal,lash,sale,seal,yeah,ash,hay,hey,lay,say,sea,she,shy,sly,yes
aside|aside,aide,aids,idea,side,aid,die,sad,sea
asking|gain,king,sank,sign,sing,sink,skin,ask,gas,sin,ski
aspect|aspect,paces,space,spate,case,cast,east,pace,past,seat,spat,step,tape,act,apt,cap,cat,eat,etc,pat,pet,sea,set,tap,tea
asset|asset,east,seat,ass,eat,sea,set,tea
assets|asset,east,seat,ass,eat,sea,set,tea
assign|assign,gain,sign,sing,ass,gas,sin
assume|assume,mass,mess,same,ass,sea,sue,sum,use
assure|assure,sure,user,ass,ear,era,sea,sue,use
asylum|slam,lay,may,say,sly,sum
athens|ashen,haste,east,hate,heat,neat,nest,seat,than,then,ash,eat,hat,net,sea,set,she,tea,ten,the
attend|attend,date,dent,neat,tend,tent,and,dna,eat,end,net,tea,ten
auburn|urban,barn,burn,ban,bar,bun,rub,run
austin|aunt,suit,unit,its,nut,sin,sit,sun
author|author,auto,hour,hurt,tour,art,hat,hot,our,out,rat
aware|aware,area,wear,ear,era,raw,war
backed|back,bade,bake,cake,deck,bad,bed,cab
backup|back,buck,pack,cab,cap,cup
badge|bade,age,bad,bag,bed,beg
badly|badly,lady,bad,bay,day,lab,lay
baker|brake,break,bake,bare,bear,bar,ear,era
baking|bank,gain,king,bag,ban,big
ballet|bleat,label,table,able,ball,beat,bell,belt,late,tale,tall,tell,all,bat,bet,eat,lab,let,tea
ballot|ballot,ball,boat,bolt,tall,toll,all,bat,lab,lot
bands|band,sand,and,bad,ban,dna,sad
banned|bade,band,bean,bend,and,bad,ban,bed,dna,end
banner|bare,barn,bean,bear,earn,near,ban,bar,ear,era
barbie|bare,bear,air,bar,ear,ebb,era,rib
barely|barely,bleary,early,layer,relay,able,bare,bear,real,rely,year,bar,bay,ear,era,lab,lay
barnes|bare,barn,base,bean,bear,earn,near,ban,bar,ear,era,sea
barrel|barrel,able,bare,bear,rare,real,rear,bar,ear,era,lab
based|bade,base,bad,bed,sad,sea
basket|basket,beast,stake,steak,bake,base,beat,best,east,sake,seat,take,task,ask,bat,bet,eat,sea,set,tea
batch|bath,act,bat,cab,cat,hat
battle|battle,bleat,table,able,beat,belt,late,tale,bat,bet,eat,lab,let,tea
beads|bade,base,bad,bed,sad,sea
bears|bare,base,bear,bar,ear,era,sea
beast|beast,base,beat,best,east,seat,bat,bet,eat,sea,set,tea
beats|beast,base,beat,best,east,seat,bat,bet,eat,sea,set,tea
beauty|beauty,beat,tube,bat,bay,bet,but,buy,eat,tea,tub,yet
beaver|brave,bare,bear,beer,ever,bar,bee,ear,era
before|before,beef,beer,free,bee,fee,for
begins|begin,being,sign,sing,beg,big,sin
behalf|behalf,able,half,heal,leaf,lab
behind|behind,bend,bind,hide,bed,bid,die,din,end
beings|begin,being,sign,sing,beg,big,sin
belief|belief,beef,feel,file,flee,life,bee,fee,lie
belkin|blink,bike,like,line,link,lie
belong|belong,globe,bone,long,beg,ego,leg,log,one
below|below,elbow,blew,blow,bowl,bow,low,owe,web
beside|beside,seed,side,bed,bee,bid,die,see
beyond|beyond,bend,body,bond,bone,deny,bed,boy,end,nod,one
bhutan|aunt,bath,hunt,than,ban,bat,bun,but,hat,nut,tub
bidder|bride,dried,bird,dire,ride,bed,bid,die,red,rib,rid
binary|brain,airy,barn,rain,air,any,ban,bar,bay,rib
bishop|bishop,ship,shop,hip,his,hop
blacks|black,slack,back,lack,sack,ask,cab,lab
blade|blade,able,bade,deal,lead,bad,bed,lab
blades|blade,able,bade,base,deal,lead,sale,seal,bad,bed,lab,sad,sea
blame|blame,able,balm,beam,male,meal,lab
blonde|blend,blond,bend,bold,bond,bone,lend,bed,end,nod,old,one
board|board,broad,road,bad,bar,rod
boards|board,broad,road,soar,bad,bar,rod,sad
boring|boring,bring,born,grin,iron,ring,big,nor,rib
boston|boost,boot,onto,soon,soot,not,son,too
bother|bother,other,throb,both,herb,hero,tore,bet,her,hot,the,toe
bottle|bottle,belt,bolt,bet,let,lot,toe
bought|ought,tough,both,bout,bug,but,gut,hot,hug,out,tub,tug
brain|brain,barn,rain,air,ban,bar,rib
brake|brake,break,bake,bare,bear,bar,ear,era
brakes|brake,break,bake,bare,base,bear,sake,ask,bar,ear,era,sea
branch|branch,ranch,barn,ban,bar,cab,can,car
brand|brand,band,barn,and,bad,ban,bar,dna
brands|brand,band,barn,sand,and,bad,ban,bar,dna,sad
brave|brave,bare,bear,bar,ear,era
breach|breach,beach,reach,bare,bear,care,each,hear,herb,race,bar,cab,car,ear,era,her
bread|bared,beard,bread,bade,bare,bear,dare,dear,read,bad,bar,bed,ear,era,red
break|brake,break,bake,bare,bear,bar,ear,era
breaks|brake,break,bake,bare,base,bear,sake,ask,bar,ear,era,sea
breast|breast,beast,stare,bare,base,bear,beat,best,east,rate,rest,seat,star,tear,art,bar,bat,bet,ear,eat,era,rat,sea,set,tea
breath|breath,earth,heart,bare,bath,bear,beat,hate,hear,heat,herb,rate,tear,art,bar,bat,bet,ear,eat,era,hat,her,rat,tea,the
breeds|beer,deer,seed,bed,bee,red,see
brian|brain,barn,rain,air,ban,bar,rib
bridal|bird,rail,aid,air,bad,bar,bid,lab,lid,rib,rid
bride|bride,bird,dire,ride,bed,bid,die,red,rib,rid
bridge|bridge,bride,ridge,bird,dire,ride,bed,beg,bid,big,die,dig,red,rib,rid
briefs|brief,fiber,fire,rife,rise,rib,sir
bright|bright,birth,right,big,bit,hit,rib
brings|bring,grin,ring,sign,sing,big,rib,sin,sir
broad|board,broad,road,bad,bar,rod
bronze|bronze,bone,born,zero,zone,nor,one
brown|brown,born,bow,nor,now,own,row
browse|worse,rose,bow,owe,row,web
brunei|burn,rein,ruin,bun,rib,rub,run
brutal|brutal,art,bar,bat,but,lab,rat,rub,tub
bryant|barn,tray,any,art,ban,bar,bat,bay,rat,try
budget|budget,debut,debt,tube,bed,beg,bet,bug,but,due,dug,get,gut,tub,tug
bufing|big,bug,bun,fug,fun,gun
bullet|bullet,bell,belt,blue,bull,tell,tube,bet,but,let,tub
bundle|blend,bend,blue,lend,bed,bun,due,end
burden|burden,under,bend,burn,bed,bun,due,end,red,rub,run
bureau|bureau,bare,bear,bar,ear,era,rub
buried|buried,bride,bird,dire,ride,bed,bid,die,due,red,rib,rid,rub
burns|burn,bun,bus,rub,run,sun
burst|burst,bust,bus,but,rub,tub
burton|born,bout,burn,torn,tour,turn,bun,but,nor,not,nut,our,out,rub,run,tub
butler|belt,blue,rule,true,tube,bet,but,let,rub,tub
butter|butter,butt,true,tube,bet,but,rub,tub
button|button,bout,butt,bun,but,not,nut,out,tub
buyers|buyer,bury,busy,sure,user,bus,buy,rub,sue,use,yes
buying|big,bug,bun,buy,gun,guy
cables|cable,scale,able,base,case,sale,seal,cab,lab,sea
cakes|cake,case,sack,sake,ask,sea
called|laced,call,cell,deal,lead,all
camera|camera,cream,area,care,cram,race,ream,arm,car,ear,era
campus|campus,camp,cap,cup,map,sum
cancer|cancer,crane,care,earn,near,race,can,car,ear,era
candle|candle,clean,dance,laced,laden,deal,land,lane,lead,lean,lend,and,can,dna,end
candy|candy,and,any,can,day,dna
carbon|carbon,barn,born,corn,ban,bar,cab,can,car,nor
career|career,care,race,rare,rear,car,ear,era
carey|care,race,year,car,cry,ear,era
caring|grain,gain,grin,rain,ring,air,can,car
carlos|solar,also,coal,oral,soar,car
carmen|crane,cream,care,cram,earn,mane,mean,name,near,race,ream,arm,can,car,ear,era,man
carpet|carpet,crept,react,trace,care,cart,pace,part,prat,race,rape,rapt,rate,tape,tear,trap,act,apt,art,cap,car,cat,ear,eat,era,etc,pat,per,pet,rap,rat,tap,tea
cart|cart,act,art,car,cat,rat
carter|react,trace,care,cart,race,rare,rate,rear,tear,act,art,car,cat,ear,eat,era,etc,rat,tea
casino|casino,coin,icon,scan,can,sin,son
castle|least,scale,stale,steal,case,cast,east,last,late,sale,salt,seal,seat,tale,act,cat,eat,etc,let,sea,set,tea
cattle|cattle,late,tale,act,cat,eat,etc,let,tea
caught|act,cat,cut,gut,hat,hug,tag,tug
cause|cause,sauce,case,cue,sea,sue,use
caused|cause,sauce,case,used,cue,due,sad,sea,sue,use
causes|cause,sauce,case,ass,cue,sea,sue,use
cedar|raced,card,care,dare,dear,race,read,car,ear,era,red
celtic|cite,tile,etc,ice,let,lie,tie
center|center,centre,recent,enter,rent,teen,tree,etc,net,ten
centre|center,centre,recent,enter,rent,teen,tree,etc,net,ten
cents|scent,nest,etc,net,set,ten
chains|chain,cash,chin,scan,ash,can,his,sin
chairs|chair,crash,cash,hair,rich,air,ash,car,his,sir
change|change,cage,each,hang,age,can
chapel|cheap,place,clap,each,heal,help,leap,pace,pale,peal,plea,cap,lap
charge|charge,grace,reach,cage,care,each,gear,hear,race,rage,age,car,ear,era,her
charm|charm,march,cram,harm,arm,car
charms|charm,crash,march,cash,cram,harm,arm,ash,car,mrs
chart|chart,cart,act,art,car,cat,hat,rat
charts|chart,crash,trash,cart,cash,cast,star,act,art,ash,car,cat,hat,rat
chase|chase,case,cash,each,ash,sea,she
cheat|cheat,teach,each,hate,heat,act,cat,eat,etc,hat,tea,the
cheats|chase,cheat,chest,haste,teach,case,cash,cast,each,east,hate,heat,seat,act,ash,cat,eat,etc,hat,sea,set,she,tea,the
cheers|cheers,cheer,sheer,here,hers,her,see,she
chorus|crush,hour,ours,rush,sour,such,our
chosen|shone,echo,nose,once,shoe,ceo,one,she,son
christ|shirt,rich,shit,stir,this,his,hit,its,sir,sit
chrome|come,core,echo,hero,home,more,ceo,her
cinema|main,mane,mean,mine,name,nice,aim,can,ice,man
cited|cite,diet,edit,tide,die,etc,ice,tie
cities|cite,site,etc,ice,its,set,sit,tie
claims|claim,islam,calm,mail,sail,slam,slim,aim
claire|clear,care,race,rail,real,rice,air,car,ear,era,ice,lie
clarke|clear,clerk,cake,care,lack,lake,race,rack,real,car,ear,era
clause|cause,sauce,scale,case,clue,sale,seal,cue,sea,sue,use
clear|clear,care,race,real,car,ear,era
client|client,cite,line,nice,tile,etc,ice,let,lie,net,ten,tie
closed|closed,close,code,cold,dose,lose,sole,ceo,old
closer|closer,close,score,core,lose,role,rose,sole,ceo
closes|close,less,lose,loss,sole,ceo
clouds|cloud,could,cold,loud,soul,old
cloudy|cloud,could,cold,loud,old,you
coast|coast,cast,coat,cost,act,cat
coated|coated,coat,code,date,act,cat,ceo,dot,eat,etc,tea,toe
coding|coin,icon,dig,din,dog,god,nod
collar|collar,local,call,coal,oral,roll,all,car
combat|combat,boat,coat,act,bat,cab,cat
cooper|cope,core,crop,poor,rope,ceo,cop,per,pro
copied|code,cope,ceo,cop,die,dip,ice,pie
copies|copse,poise,scope,cope,pose,ceo,cop,ice,pie
copper|cope,core,crop,rope,ceo,cop,per,pop,pro
corner|corner,core,corn,once,ceo,nor,one
corpus|coup,crop,ours,pour,soup,sour,spur,cop,cup,our,pro
costa|coast,cast,coat,cost,act,cat
counts|count,cost,cut,not,nut,out,son,sun
county|county,count,cut,not,nut,out,toy,you
couple|couple,clue,cope,coup,pole,ceo,cop,cue,cup
course|course,source,score,core,cure,ours,rose,sour,sure,user,ceo,cue,our,sue,use
court|court,curt,tour,cut,our,out
courts|court,cost,curt,ours,sort,sour,tour,cut,our,out
covers|cover,score,core,over,rose,ceo
cradle|clear,laced,raced,card,care,dare,deal,dear,lead,race,read,real,car,ear,era,red
craft|craft,cart,fact,act,art,car,cat,far,fat,rat
crafts|craft,cart,cast,fact,fast,star,act,art,car,cat,far,fat,rat
cream|cream,care,cram,race,ream,arm,car,ear,era
create|create,react,trace,care,cart,race,rate,tear,tree,act,art,car,cat,ear,eat,era,etc,rat,tea
credit|credit,direct,tired,trice,cite,diet,dire,dirt,edit,rice,ride,tide,tire,die,etc,ice,red,rid,tie
crimes|crime,rice,rise,ice,mrs,rim,sir
crowd|crowd,cord,word,cow,rod,row
crown|corn,cow,nor,now,own,row
cruise|cruise,cure,rice,rise,sure,user,cue,ice,sir,sue,use
curtis|curt,stir,suit,cut,its,sir,sit
curves|curve,cure,sure,user,cue,sue,use
custom|custom,cost,most,must,cut,out,sum
daily|daily,lady,aid,day,lay,lid
dairy|diary,airy,yard,aid,air,day,dry,rid
danger|danger,garden,anger,grade,grand,raged,range,dare,dear,drag,earn,gear,near,rage,read,age,and,dna,ear,end,era,red
daniel|denial,nailed,alien,ideal,laden,aide,deal,idea,lain,land,lane,lead,lean,lend,line,nail,aid,and,die,din,dna,end,lid,lie
danish|aids,dish,hand,sand,aid,and,ash,din,dna,his,sad,sin
dare|dare,dear,read,ear,era,red
darwin|inward,drain,drawn,dawn,draw,rain,warn,wind,aid,air,and,din,dna,raw,rid,wan,war,win
dated|date,dead,add,dad,eat,tea
dates|date,east,seat,eat,sad,sea,set,tea
dating|giant,gain,gait,aid,and,dig,din,dna,tag
dayton|today,and,any,day,dna,dot,nod,not,toy
deadly|deadly,delay,dead,deal,eddy,lady,lead,add,dad,day,lay
dealer|dealer,leader,elder,dare,deal,dear,deer,lead,leer,read,real,ear,era,red
deals|deal,lead,sale,seal,sad,sea
dealt|date,deal,late,lead,tale,eat,let,tea
dear|dare,dear,read,ear,era,red
death|death,date,hate,head,heat,eat,hat,tea,the
deaths|death,haste,shade,date,east,hate,head,heat,seat,shed,ash,eat,hat,sad,sea,set,she,tea,the
debate|debate,bated,bade,beat,date,debt,bad,bat,bed,bee,bet,eat,tea
debian|aide,bade,band,bean,bend,bind,idea,aid,and,bad,ban,bed,bid,die,din,dna,end
debut|debut,debt,tube,bed,bet,but,due,tub
decent|decent,dent,need,teen,tend,end,etc,net,ten
decor|code,cord,core,ceo,red,rod
deeper|peered,deep,deer,peer,per,red
deeply|deeply,yelped,deep,peel,yelp,eye
defeat|defeat,date,fade,fate,feed,eat,fat,fee,tea
define|define,feed,find,fine,need,die,din,end,fee
delay|delay,deal,lady,lead,day,lay
delays|delay,deal,easy,lady,lead,sale,seal,day,lay,sad,say,sea,sly,yes
delta|date,deal,late,lead,tale,eat,let,tea
demand|demand,damn,dead,mane,mean,name,add,and,dad,dam,dna,end,mad,man
denial|denial,nailed,alien,ideal,laden,aide,deal,idea,lain,land,lane,lead,lean,lend,line,nail,aid,and,die,din,dna,end,lid,lie
dennis|snide,nine,send,side,die,din,end,sin
dense|dense,need,seed,send,end,see
dental|laden,date,deal,dent,land,lane,late,lead,lean,lend,neat,tale,tend,and,dna,eat,end,let,net,tea,ten
denver|nerve,never,deer,even,ever,need,end,red
depot|poet,dot,opt,pet,pot,toe,top
deputy|deputy,duty,type,due,pet,put,yet
desert|desert,steer,deer,rest,seed,tree,red,see,set
design|design,singed,deign,snide,send,side,sign,sing,die,dig,din,end,sin
desire|desire,deer,dire,ride,rise,seed,side,die,red,rid,see,sir
detail|detail,ideal,tidal,aide,date,deal,diet,edit,idea,late,lead,tail,tale,tide,tile,aid,die,eat,let,lid,lie,tea,tie
devil|devil,evil,live,vied,die,lid,lie
dialog|glad,goal,gold,load,ago,aid,dig,dog,god,lid,log,oil,old
diane|aide,idea,aid,and,die,din,dna,end
diary|diary,airy,yard,aid,air,day,dry,rid
dicks|disc,disk,sick,skid,kid,ski
diesel|sidle,slide,else,seed,side,slid,die,lid,lie,see
differ|differ,dire,fire,ride,rife,die,red,rid
digest|diet,edit,side,site,tide,die,dig,get,its,set,sit,tie
dinner|dinner,inner,dire,nine,rein,ride,die,din,end,red,rid
direct|credit,direct,tired,trice,cite,diet,dire,dirt,edit,rice,ride,tide,tire,die,etc,ice,red,rid,tie
dirty|dirty,dirt,tidy,dry,rid,try
dishes|hissed,dish,hide,shed,side,die,his,she
disney|snide,deny,send,side,die,din,end,sin,yes
doctor|doctor,cord,door,root,trod,dot,rod,too
dollar|doll,load,lord,oral,road,roll,all,old,rod
domain|domain,amid,damn,main,mind,aid,aim,and,dam,dim,din,dna,mad,man,nod
donald|land,load,loan,add,and,dad,dna,nod,odd,old
donate|donate,date,dent,neat,note,tend,tone,and,dna,dot,eat,end,net,nod,not,one,tea,ten,toe
donors|donor,door,soon,nod,nor,rod,son
dosage|dose,age,ago,dog,ego,gas,god,sad,sea
double|double,blue,bold,loud,bed,due,old
doubt|doubt,bout,but,dot,out,tub
dozens|dozen,dose,nose,send,zone,end,nod,one,son
draft|draft,dart,art,far,fat,rat
dragon|grand,organ,drag,road,ago,and,dna,dog,god,nod,nor,rod
drain|drain,rain,aid,air,and,din,dna,rid
drawn|drawn,dawn,draw,warn,and,dna,raw,wan,war
dream|armed,dream,dare,dear,read,ream,arm,dam,ear,era,mad,red
dreams|armed,dream,dare,dear,read,ream,same,arm,dam,ear,era,mad,mrs,red,sad,sea
dried|dried,dire,ride,die,red,rid
drinks|drink,disk,kind,risk,sink,skid,skin,din,kid,rid,sin,sir,ski
drive|drive,dire,ride,vied,die,red,rid
driven|drive,dire,rein,ride,vied,die,din,end,red,rid
driver|driver,drive,rider,river,dire,ride,vied,die,red,rid
drives|drive,dire,ride,rise,side,vied,die,red,rid,sir
dublin|blind,build,bind,bid,bun,din,lid
durham|drum,hard,harm,arm,dam,mad,mud
during|during,drug,grin,ring,ruin,dig,din,dug,gun,rid,run
duties|suite,diet,dust,edit,side,site,suit,tide,used,die,due,its,set,sit,sue,tie,use
dylan|lady,land,and,any,day,dna,lay
eagles|ease,else,gale,glee,sale,seal,age,gas,leg,sea,see
early|early,layer,relay,real,rely,year,ear,era,lay
earned|earned,neared,dare,dear,deer,earn,near,need,read,and,dna,ear,end,era,red
earth|earth,heart,hate,hear,heat,rate,tear,art,ear,eat,era,hat,her,rat,tea,the
easier|arise,raise,ease,rise,air,ear,era,sea,see,sir
easily|easily,aisle,easy,sail,sale,seal,lay,lie,say,sea,sly,yes
east|east,seat,eat,sea,set,tea
easter|stare,steer,ease,east,rate,rest,seat,star,tear,tree,art,ear,eat,era,rat,sea,see,set,tea
eating|eating,agent,giant,tinge,gain,gait,gate,neat,age,eat,get,net,tag,tea,ten,tie
edgar|grade,raged,dare,dear,drag,gear,rage,read,age,ear,era,red
editor|editor,tired,diet,dire,dirt,edit,ride,riot,tide,tire,tore,trod,die,dot,red,rid,rod,tie,toe
edward|waded,dare,dead,dear,draw,read,wear,add,dad,ear,era,raw,red,war,wed
effort|effort,offer,fret,tore,for,off,toe
either|either,their,there,three,here,hire,tire,tree,her,hit,the,tie
email|mail,male,meal,mile,aim,lie
emails|aisle,islam,smile,mail,male,meal,mile,sail,sale,same,seal,slam,slim,aim,lie,sea
empire|empire,prime,mere,peer,per,pie,rim,rip
enable|enable,able,bean,lane,lean,ban,bee,lab
ending|deign,nine,die,dig,din,end
energy|energy,genre,green,gene,grey,eye
enough|enough,huge,ego,gun,hue,hug,one
ensure|nurse,sneer,sure,user,run,see,sue,sun,use
enter|enter,rent,teen,tree,net,ten
enters|enter,sneer,steer,stern,nest,rent,rest,teen,tree,net,see,set,ten
entire|entire,enter,inter,rein,rent,teen,tire,tree,net,ten,tie
entity|entity,tent,tiny,net,ten,tie,yet
entry|entry,rent,net,ten,try,yet
epson|nose,open,pose,one,pen,son
equity|equity,quiet,quite,quit,tie,yet
escape|escape,cease,paces,peace,space,case,ease,pace,cap,sea,see
essay|essay,easy,ass,say,sea,yes
essays|essay,easy,ass,say,sea,yes
estate|estate,state,taste,ease,east,seat,test,eat,sea,see,set,tea
ethics|ethics,chest,cite,shit,site,this,etc,his,hit,ice,its,set,she,sit,the,tie
ethnic|ethnic,chin,cite,hint,nice,then,thin,etc,hit,ice,net,ten,the,tie
europe|peer,pour,pure,rope,our,per,pro
euros|ours,rose,sour,sure,user,our,sue,use
event|event,even,teen,vent,net,ten
events|event,seven,even,nest,teen,vent,net,see,set,ten
exact|exact,act,cat,eat,etc,tax,tea
excuse|excuse,cue,see,sex,sue,use
exist|exist,exit,site,its,set,sex,sit,six,tie
exists|exist,exit,site,its,set,sex,sit,six,tie
exotic|exotic,toxic,cite,exit,ceo,etc,ice,tie,toe
expand|expand,and,dna,end,pad,pan,pen
export|export,poet,port,rope,tore,opt,per,pet,pot,pro,toe,top
extend|extend,dent,need,next,teen,tend,end,net,ten
extent|extent,next,teen,tent,text,net,ten
extra|extra,rate,tear,art,ear,eat,era,rat,tax,tea
extras|extra,stare,east,rate,rest,seat,star,tear,art,ear,eat,era,rat,sea,set,sex,tax,tea
fabric|fabric,fair,air,bar,cab,car,far,rib
factor|factor,actor,craft,cart,coat,fact,act,art,car,cat,far,fat,for,rat
facts|cast,fact,fast,act,cat,fat
failed|field,ideal,aide,deal,fade,fail,file,idea,lead,leaf,life,aid,die,lid,lie
fairly|fairly,frail,airy,fail,fair,flay,rail,air,far,fly,lay
fallen|fall,lane,leaf,lean,all,fan
false|false,leaf,safe,sale,seal,self,sea
family|family,fail,film,flay,mail,aim,fly,lay,may
fares|fare,fear,safe,ear,era,far,sea
farmer|farmer,frame,fame,fare,farm,fear,rare,ream,rear,arm,ear,era,far
faster|faster,after,feast,stare,east,fare,fast,fate,fear,fret,rate,rest,safe,seat,star,tear,art,ear,eat,era,far,fat,rat,sea,set,tea
father|father,after,earth,heart,fare,fate,fear,fret,hate,hear,heat,rate,tear,art,ear,eat,era,far,fat,hat,her,rat,tea,the
favour|favor,four,far,for,fur,our
fears|fare,fear,safe,ear,era,far,sea
feels|else,feel,flee,self,fee,see
fellow|fellow,flew,flow,well,wolf,few,low,owe
female|female,flame,fame,feel,flee,leaf,male,meal,fee
fetish|shift,fish,fist,shit,site,this,fit,his,hit,its,set,she,sit,the,tie
field|field,file,life,die,lid,lie
fields|field,sidle,slide,file,life,self,side,slid,die,lid,lie
figure|figure,grief,fire,rife,urge,fug,fur
filed|field,file,life,die,lid,lie
filled|field,file,fill,life,die,ill,lid,lie
filter|filter,rifle,file,fire,flit,fret,left,life,lift,rife,tile,tire,fit,let,lie,tie
finals|final,fail,lain,nail,sail,fan,sin
finder|friend,finer,dire,find,fine,fire,rein,ride,rife,die,din,end,red,rid
finest|fine,fist,nest,site,fit,its,net,set,sin,sit,ten,tie
finger|finger,feign,finer,grief,fine,fire,grin,rein,rife,ring
fired|dire,fire,ride,rife,die,red,rid
first|first,fist,stir,fit,its,sir,sit
fisher|fresh,fire,fish,hers,hire,rife,rise,her,his,she,sir
fitted|fitted,fetid,diet,edit,tide,die,fit,tie
fleet|fleet,feel,flee,left,fee,let
flight|flight,fight,light,flit,gift,lift,fit,hit
floral|fall,oral,roll,all,far,for
flour|flour,foul,four,for,fur,our
flower|flower,lower,flew,flow,role,wolf,few,for,low,owe,row
folder|fold,lord,role,for,old,red,rod
forced|force,code,cord,core,ceo,for,red,rod
forces|force,score,core,rose,ceo,for
forest|forest,foster,store,fret,rest,rose,soft,sort,tore,for,set,toe
forget|forget,forge,fret,tore,ego,fog,for,get,toe
forgot|forgo,foot,roof,root,fog,for,too
formal|formal,moral,farm,form,from,oral,roam,arm,far,for
format|format,farm,form,from,roam,arm,art,far,fat,for,rat
formed|form,from,mode,more,for,red,rod
former|former,reform,form,from,more,for
forum|forum,form,four,from,for,fur,our
forums|forum,form,four,from,ours,sour,for,fur,mrs,our,sum
foster|forest,foster,store,fret,rest,rose,soft,sort,tore,for,set,toe
fought|ought,tough,fog,fug,gut,hot,hug,out,tug
fourth|fourth,forth,four,hour,hurt,tour,for,fur,hot,our,out
frame|frame,fame,fare,farm,fear,ream,arm,ear,era,far
framed|framed,armed,dream,frame,dare,dear,fade,fame,fare,farm,fear,read,ream,arm,dam,ear,era,far,mad,red
frames|frame,fame,fare,farm,fear,ream,safe,same,arm,ear,era,far,mrs,sea
france|crane,care,earn,face,fare,fear,near,race,can,car,ear,era,fan,far
fraser|fare,fear,rare,rear,safe,ear,era,far,sea
freely|freely,feel,flee,free,leer,rely,eye,fee,fly
friday|friday,diary,airy,fair,yard,aid,air,day,dry,far,rid
fridge|grief,ridge,dire,fire,ride,rife,die,dig,red,rid
friend|friend,finer,dire,find,fine,fire,rein,ride,rife,die,din,end,red,rid
frozen|frozen,zero,zone,for,nor,one
fruits|first,fruit,fist,stir,suit,fit,fur,its,sir,sit
gained|gained,deign,aide,gain,idea,age,aid,and,die,dig,din,dna,end
garage|garage,area,gear,rage,age,ear,egg,era
garden|danger,garden,anger,grade,grand,raged,range,dare,dear,drag,earn,gear,near,rage,read,age,and,dna,ear,end,era,red
garmin|margin,grain,gain,grim,grin,main,rain,ring,aim,air,arm,man,rim
gate|gate,age,eat,get,tag,tea
gates|stage,east,gate,seat,age,eat,gas,get,sea,set,tag,tea
gather|gather,earth,grate,great,heart,gate,gear,hate,hear,heat,rage,rate,tear,age,art,ear,eat,era,get,hat,her,rat,tag,tea,the
gender|gender,genre,green,deer,edge,gene,need,end,red
genius|genius,sign,sing,snug,gun,sin,sue,sun,use
gentle|gentle,gene,glee,teen,get,leg,let,net,ten
gently|gently,get,leg,let,net,ten,yet
gerald|glared,glare,grade,large,raged,dare,deal,dear,drag,gale,gear,glad,lead,rage,read,real,age,ear,era,leg,red
german|german,anger,range,earn,game,gear,mane,mean,name,near,rage,ream,age,arm,ear,era,man
giants|giant,gain,gait,sign,sing,gas,its,sin,sit,tag
gibson|sign,sing,song,big,sin,son
glance|glance,angel,angle,clang,clean,cage,gale,lane,lean,age,can,leg
global|global,ball,goal,ago,all,bag,lab,log
gloves|glove,solve,lose,love,sole,ego,leg,log
golden|golden,ogled,gold,lend,long,dog,ego,end,god,leg,log,nod,old,one
gordon|donor,door,good,dog,god,nod,nor,rod
gospel|slope,lose,pole,pose,slop,sole,ego,leg,log
gotten|note,tent,tone,ego,get,net,not,one,ten,toe
grace|grace,cage,care,gear,race,rage,age,car,ear,era
grade|grade,raged,dare,dear,drag,gear,rage,read,age,ear,era,red
grades|grade,raged,dare,dear,drag,gear,rage,rags,read,age,ear,era,gas,red,sad,sea
grain|grain,gain,grin,rain,ring,air
grande|danger,garden,anger,grade,grand,raged,range,dare,dear,drag,earn,gear,near,rage,read,age,and,dna,ear,end,era,red
grants|grant,rags,star,art,gas,rat,tag
graphs|grasp,sharp,gash,gasp,rags,rasp,ash,gap,gas,rap
gratis|stair,gait,rags,star,stir,air,art,gas,its,rat,sir,sit,tag
grave|grave,gear,rage,age,ear,era
great|grate,great,gate,gear,rage,rate,tear,age,art,ear,eat,era,get,rat,tag,tea
ground|ground,round,drug,dog,dug,god,gun,nod,nor,our,rod,run
groups|group,ours,pour,soup,sour,spur,our,pro
grown|wrong,grow,nor,now,own,row
growth|growth,throw,worth,grow,hot,how,row,two,who
guards|guard,sugar,drag,drug,rags,dug,gas,sad
guest|guest,gust,get,gut,set,sue,tug,use
guests|guess,guest,gust,get,gut,set,sue,tug,use
guides|guide,side,used,die,dig,due,dug,sue,use
guilty|guilty,guilt,ugly,gut,guy,tug
guitar|guitar,gait,air,art,gut,rat,tag,tug
habits|habit,bath,bias,shit,this,ash,bat,bit,hat,his,hit,its,sit
hacker|reach,cake,care,each,hear,race,rack,car,ear,era,her
hammer|harm,hear,ream,arm,ear,era,her
handed|handed,dead,hand,head,add,and,dad,dna,end
handle|handle,laden,deal,hand,head,heal,land,lane,lead,lean,lend,and,dna,end
hands|hand,sand,and,ash,dna,sad
handy|hand,and,any,day,dna,hay
harder|dare,dear,hard,head,hear,rare,read,rear,ear,era,her,red
hardly|hardly,hard,lady,yard,day,dry,hay,lay
harley|early,layer,relay,heal,hear,real,rely,yeah,year,ear,era,hay,her,hey,lay
harold|hard,hold,load,lord,oral,road,old,rod
harper|hear,rape,rare,rear,ear,era,her,per,rap
harvey|heavy,have,hear,vary,very,yeah,year,ear,era,hay,her,hey
hate|hate,heat,eat,hat,tea,the
hayes|easy,yeah,ash,hay,hey,say,sea,she,shy,yes
header|dare,dear,deer,hard,head,hear,here,read,ear,era,her,red
heads|shade,head,shed,ash,sad,sea,she
health|health,halt,hate,heal,heat,late,tale,eat,hat,let,tea,the
heard|dare,dear,hard,head,hear,read,ear,era,her,red
heart|earth,heart,hate,hear,heat,rate,tear,art,ear,eat,era,hat,her,rat,tea,the
hearts|earth,haste,heart,share,stare,trash,east,hate,hear,heat,hers,rate,rest,seat,star,tear,art,ash,ear,eat,era,hat,her,rat,sea,set,she,tea,the
heat|hate,heat,eat,hat,tea,the
heated|death,date,hate,head,heat,eat,hat,tea,the
heater|earth,heart,there,three,hate,hear,heat,here,rate,tear,tree,art,ear,eat,era,hat,her,rat,tea,the
heath|hate,heat,eat,hat,tea,the
hebrew|where,beer,herb,here,bee,her,web
height|eighth,height,eight,thigh,high,get,hit,the,tie
helmet|helmet,theme,heel,meet,melt,them,let,the
herald|dare,deal,dear,hard,head,heal,hear,lead,read,real,ear,era,her,red
herbal|able,bare,bear,heal,hear,herb,real,bar,ear,era,her,lab
hereby|hereby,beer,herb,here,bee,eye,her,hey
heroes|horse,sheer,shore,here,hero,hers,rose,shoe,her,see,she
hilton|hint,into,lion,thin,hit,hot,lot,not,oil
hints|hint,shit,thin,this,his,hit,its,sin,sit
hired|dire,hide,hire,ride,die,her,red,rid
hist|shit,this,his,hit,its,sit
hits|shit,this,his,hit,its,sit
holdem|model,hold,hole,home,mode,old
holder|hero,hold,hole,lord,role,her,old,red,rod
holmes|hole,home,lose,shoe,sole,some,she
honest|honest,shone,stone,those,host,nest,nose,note,shoe,shot,then,tone,hot,net,not,one,set,she,son,ten,the,toe
hopes|hope,pose,shoe,shop,hop,she
horse|horse,shore,hero,hers,rose,shoe,her,she
horses|horse,shore,hero,hers,rose,shoe,her,she
hosted|dotes,those,dose,host,shed,shoe,shot,dot,hot,set,she,the,toe
hostel|hotel,stole,those,hole,host,lose,lost,lots,shoe,shot,slot,sole,hot,let,lot,set,she,the,toe
hotel|hotel,hole,hot,let,lot,the,toe
hotels|hotel,stole,those,hole,host,lose,lost,lots,shoe,shot,slot,sole,hot,let,lot,set,she,the,toe
hourly|holy,hour,hurl,your,our,you
house|house,shoe,hue,she,sue,use
houses|house,shoe,hue,she,sue,use
howard|draw,hard,road,word,how,raw,rod,row,war,who
hughes|gush,huge,hush,hue,hug,huh,she,sue,use
hunger|hunger,huge,urge,gun,her,hue,hug,run
hunter|hunter,hunt,hurt,rent,then,true,tune,turn,her,hue,net,nut,run,ten,the
ideal|ideal,aide,deal,idea,lead,aid,die,lid,lie
ideas|aside,aide,aids,idea,side,aid,die,sad,sea
ignore|ignore,region,grin,iron,rein,ring,ego,nor,one
images|image,game,same,age,aim,gas,sea
impact|impact,camp,act,aim,apt,cap,cat,map,pat,pit,tap,tip
import|import,port,riot,trim,trip,mop,opt,pit,pot,pro,rim,rip,tip,top
impose|impose,poise,poem,pose,some,mop,pie
inches|shine,since,chin,nice,his,ice,she,sin
income|income,coin,come,icon,mine,nice,once,ceo,ice,one
indoor|donor,door,iron,din,nod,nor,rid,rod
inform|inform,minor,firm,form,from,iron,norm,for,nor,rim
inkjet|knit,jet,kit,net,ten,tie
input|input,unit,nip,nut,pin,pit,put,tip
inputs|input,spin,spit,spun,suit,unit,its,nip,nut,pin,pit,put,sin,sit,sun,tip
insert|insert,inter,stern,nest,rein,rent,rest,rise,site,stir,tire,its,net,set,sin,sir,sit,ten,tie
inside|inside,snide,send,side,die,din,end,sin
intake|intake,knit,neat,take,tank,eat,kit,net,tea,ten,tie
intel|line,tile,let,lie,net,ten,tie
intend|intend,tinned,dent,diet,edit,nine,tend,tide,die,din,end,net,ten,tie
intent|intent,nine,tent,net,ten,tie
inter|inter,rein,rent,tire,net,ten,tie
intro|into,iron,riot,torn,nor,not
invest|invest,veins,nest,site,vent,its,net,set,sin,sit,ten,tie
islam|islam,mail,sail,slam,slim,aim
island|island,aids,lain,land,nail,sail,sand,slid,aid,and,din,dna,lid,sad,sin
israel|aisle,arise,laser,raise,rail,real,rise,sail,sale,seal,air,ear,era,lie,sea,sir
issued|issued,issue,side,used,die,due,sue,use
items|item,mist,site,stem,time,its,set,sit,tie
itself|itself,stifle,file,fist,flit,left,life,lift,list,self,site,slit,tile,fit,its,let,lie,set,sit,tie
itunes|suite,unite,nest,site,suit,tune,unit,its,net,nut,set,sin,sit,sue,sun,ten,tie,use
jacket|jacket,cake,take,act,cat,eat,etc,jet,tea
janet|neat,eat,jet,net,tea,ten
jewish|jewish,wise,wish,his,jew,she
joined|join,die,din,end,nod,one
jordan|road,and,dna,jar,nod,nor,rod
joseph|hope,pose,shoe,shop,hop,she
judges|judge,used,due,dug,sue,use
junior|junior,iron,join,ruin,nor,our,run
justin|just,suit,unit,its,nut,sin,sit,sun
kidney|deny,kind,die,din,end,key,kid
killed|kill,like,die,ill,kid,lid,lie
kinase|skein,snake,sneak,sake,sank,sink,skin,ask,sea,sin,ski
kinda|dank,kind,aid,and,din,dna,kid
kinds|disk,kind,sink,skid,skin,din,kid,sin,ski
kings|king,sign,sing,sink,skin,sin,ski
knight|night,thing,think,hint,king,knit,thin,hit,kit
knives|skein,veins,sink,skin,sin,ski
korean|korean,earn,near,rank,ear,era,nor,oak,one
label|label,able,ball,bell,all,lab
labels|label,able,ball,base,bell,sale,seal,sell,all,lab,sea
labour|labor,oral,bar,lab,our,rub
ladder|ladder,dare,dead,deal,dear,lead,read,real,add,dad,ear,era,red
laden|laden,deal,land,lane,lead,lean,lend,and,dna,end
ladies|sailed,aisle,aside,ideal,sidle,slide,aide,aids,deal,idea,lead,sail,sale,seal,side,slid,aid,die,lid,lie,sad,sea
lakes|lake,sake,sale,seal,ask,sea
lamps|lamp,palm,slam,slap,lap,map
lanes|lane,lean,lens,sale,seal,sea
laptop|atop,plot,apt,lap,lot,opt,pat,pop,pot,tap,top
large|glare,large,gale,gear,rage,real,age,ear,era,leg
larger|glare,large,gale,gear,rage,rare,real,rear,age,ear,era,leg
laser|laser,real,sale,seal,ear,era,sea
lately|lately,alley,tally,ally,late,tale,tall,tell,yell,all,eat,lay,let,tea,yet
later|alter,later,late,rate,real,tale,tear,art,ear,eat,era,let,rat,tea
latest|least,stale,state,steal,taste,east,last,late,sale,salt,seal,seat,tale,test,eat,let,sea,set,tea
latex|late,tale,eat,let,tax,tea
latino|latin,into,lain,lion,loan,nail,tail,lot,not,oil
latter|latter,rattle,alter,later,treat,late,rate,real,tale,tear,art,ear,eat,era,let,rat,tea
lauren|learn,earn,lane,lean,near,real,rule,ear,era,run
lawyer|lawyer,early,layer,relay,weary,real,rely,wary,weal,wear,year,ear,era,law,lay,raw,war,way
layer|early,layer,relay,real,rely,year,ear,era,lay
layers|early,laser,layer,relay,easy,real,rely,sale,seal,year,ear,era,lay,say,sea,sly,yes
layout|auto,lay,lot,out,toy,you
leader|dealer,leader,elder,dare,deal,dear,deer,lead,leer,read,real,ear,era,red
leads|deal,lead,sale,seal,sad,sea
learn|learn,earn,lane,lean,near,real,ear,era
lease|ease,else,sale,seal,sea,see
least|least,stale,steal,east,last,late,sale,salt,seal,seat,tale,eat,let,sea,set,tea
leaves|leave,slave,ease,else,sale,save,seal,sea,see
legacy|legacy,cage,clay,gale,age,gay,lay,leg
legend|legend,edge,gene,glee,lend,need,end,leg
lender|elder,deer,leer,lend,need,end,red
length|length,then,get,leg,let,net,ten,the
lenses|lessen,sense,else,lens,less,see
lesson|lesson,lens,less,lose,loss,nose,sole,one,son
liable|label,able,ball,bell,bill,all,ill,lab,lie
lights|slight,light,sight,list,shit,sigh,slit,this,his,hit,its,sit
likely|likely,kill,like,yell,ill,key,lie
limits|limit,list,mist,slim,slit,its,sit
linda|lain,land,nail,aid,and,din,dna,lid
linear|alien,learn,earn,lain,lane,lean,line,nail,near,rail,rain,real,rein,air,ear,era,lie
lined|lend,line,die,din,end,lid,lie
linked|kind,lend,like,line,link,die,din,end,kid,lid,lie
links|link,silk,sink,skin,sin,ski
listed|sidle,slide,diet,edit,list,side,site,slid,slit,tide,tile,die,its,let,lid,lie,set,sit,tie
listen|listen,silent,lens,line,list,nest,site,slit,tile,its,let,lie,net,set,sin,sit,ten,tie
little|little,title,tell,tile,till,ill,let,lie,tie
lived|devil,evil,live,vied,die,lid,lie
loaded|dead,deal,lead,load,add,dad,odd,old
locale|local,call,cell,coal,all,ceo
locate|locate,coal,coat,late,tale,act,cat,ceo,eat,etc,let,lot,tea,toe
locked|code,cold,deck,dock,lock,ceo,old
lodge|ogled,gold,dog,ego,god,leg,log,old
logan|along,goal,loan,long,ago,log
logged|ogled,gold,dog,egg,ego,god,leg,log,old
longer|long,role,ego,leg,log,nor,one
losing|lion,long,sign,sing,soil,song,log,oil,sin,son
lotus|lost,lots,slot,soul,lot,out
louise|lose,soil,sole,soul,lie,oil,sue,use
lounge|lunge,long,lung,ego,gun,leg,log,one
lovers|lover,solve,lose,love,over,role,rose,sole
lowest|stole,towel,welts,lose,lost,lots,slot,slow,sole,stow,west,let,lot,low,owe,set,toe,two,wet
luther|hurtle,hurl,hurt,rule,true,her,hue,let,the
madrid|amid,add,aid,aim,air,arm,dad,dam,dim,mad,rid,rim
magnet|agent,game,gate,mane,mate,mean,meat,name,neat,team,age,eat,get,man,net,tag,tea,ten
maiden|aimed,media,aide,amid,damn,idea,main,mane,mean,mind,mine,name,aid,aim,and,dam,die,dim,din,dna,end,mad,man
mailed|aimed,ideal,medal,media,aide,amid,deal,idea,lead,mail,male,meal,mild,mile,aid,aim,dam,die,dim,lid,lie,mad
mails|islam,mail,sail,slam,slim,aim
maine|main,mane,mean,mine,name,aim,man
mainly|mainly,lain,mail,main,many,nail,aim,any,lay,man,may
maker|maker,make,mark,ream,arm,ear,era
makers|maker,make,mark,mask,ream,sake,same,arm,ask,ear,era,mrs,sea
makes|make,mask,sake,same,ask,sea
males|male,meal,sale,same,seal,slam,sea
manage|manage,game,mane,mean,name,age,man
manner|manner,earn,mane,mean,name,near,ream,arm,ear,era,man
manor|roman,norm,roam,arm,man,nor
maple|ample,lamp,leap,male,meal,pale,palm,peal,plea,lap,map
marble|marble,blame,realm,able,balm,bare,beam,bear,male,meal,real,ream,arm,bar,ear,era,lab
march|charm,march,cram,harm,arm,car
mardi|amid,aid,aim,air,arm,dam,dim,mad,rid,rim
margin|margin,grain,gain,grim,grin,main,rain,ring,aim,air,arm,man,rim
mariah|hair,harm,aim,air,arm,him,rim
marie|ream,aim,air,arm,ear,era,rim
marina|main,rain,aim,air,arm,man,rim
marine|marine,remain,earn,main,mane,mean,mine,name,near,rain,ream,rein,aim,air,arm,ear,era,man,rim
marion|minor,roman,iron,main,norm,rain,roam,aim,air,arm,man,nor,rim
marked|armed,dream,maker,raked,dare,dark,dear,make,mark,read,ream,arm,dam,ear,era,mad,red
marker|marker,remark,maker,make,mark,rare,ream,rear,arm,ear,era
market|market,maker,make,mark,mate,meat,rate,ream,take,team,tear,term,arm,art,ear,eat,era,rat,tea
martha|harm,math,arm,art,hat,rat
martin|train,main,rain,trim,aim,air,arm,art,man,rat,rim
marvel|realm,male,meal,real,ream,arm,ear,era
master|master,stream,smart,stare,steam,terms,east,mate,meat,rate,ream,rest,same,seat,star,stem,team,tear,term,arm,art,ear,eat,era,mrs,rat,sea,set,tea
mating|giant,gain,gait,main,aim,man,tag
matrix|trim,aim,air,arm,art,mix,rat,rim,tax
matter|matter,matte,treat,mate,meat,rate,ream,team,tear,term,arm,art,ear,eat,era,rat,tea
mature|mate,meat,rate,ream,team,tear,term,true,arm,art,ear,eat,era,rat,tea
meals|male,meal,sale,same,seal,slam,sea
means|means,mane,mean,name,same,man,sea
meant|mane,mate,mean,meat,name,neat,team,eat,man,net,tea,ten
medal|medal,deal,lead,male,meal,dam,mad
media|aimed,media,aide,amid,idea,aid,aim,dam,die,dim,mad
median|aimed,media,aide,amid,damn,idea,main,mane,mean,mind,mine,name,aid,aim,and,dam,die,dim,din,dna,end,mad,man
medium|medium,die,dim,due,mud,mum
mental|mental,metal,lane,late,lean,male,mane,mate,meal,mean,meat,melt,name,neat,tale,team,eat,let,man,net,tea,ten
mentor|mentor,more,norm,note,rent,term,tone,tore,torn,net,nor,not,one,ten,toe
merit|merit,item,term,time,tire,trim,rim,tie
metal|metal,late,male,mate,meal,meat,melt,tale,team,eat,let,tea
metals|least,metal,stale,steal,steam,east,last,late,male,mate,meal,meat,melt,sale,salt,same,seal,seat,slam,stem,tale,team,eat,let,sea,set,tea
meters|merest,meter,steer,terms,meet,mere,rest,seem,stem,term,tree,mrs,see,set
method|method,home,mode,them,dot,hot,the,toe
metres|merest,meter,steer,terms,meet,mere,rest,seem,stem,term,tree,mrs,see,set
metric|crime,merit,trice,cite,item,rice,term,time,tire,trim,etc,ice,rim,tie
middle|middle,mild,mile,die,dim,lid,lie
milan|lain,mail,main,nail,aim,man
minute|minute,unite,item,menu,mine,time,tune,unit,net,nut,ten,tie
mobile|mobile,limbo,boil,limb,mile,lie,oil
models|seldom,model,dose,lose,mode,sole,some,old
modern|modern,drone,mode,more,norm,end,nod,nor,one,red,rod
module|model,loud,mode,due,mud,old
moment|moment,note,tone,mom,net,not,one,ten,toe
monday|monday,damn,many,and,any,dam,day,dna,mad,man,may,nod
monica|coin,icon,main,aim,can,man
monroe|moon,more,norm,room,nor,one
monte|note,tone,net,not,one,ten,toe
months|month,host,most,shot,hot,not,son
morgan|among,organ,roman,norm,roam,ago,arm,man,nor
mostly|mostly,lost,lots,most,slot,lot,sly,toy
motels|stole,lose,lost,lots,melt,most,slot,sole,some,stem,let,lot,set,toe
mother|mother,other,hero,home,more,term,them,tore,her,hot,the,toe
motion|motion,into,moon,onto,not,too
motors|motor,storm,most,room,root,soot,sort,mrs,too
mounts|mount,most,must,not,nut,out,son,sum,sun
movers|more,move,over,rose,some,mrs
muscle|muscle,clue,cue,sue,sum,use
myrtle|melt,rely,term,let,try,yet
named|damn,mane,mean,name,and,dam,dna,end,mad,man
namely|lane,lean,male,mane,many,meal,mean,name,any,lay,man,may
names|means,mane,mean,name,same,man,sea
naples|lapse,panel,plane,lane,lean,leap,lens,pale,peal,plan,plea,sale,seal,slap,snap,lap,pan,pen,sea
narrow|narrow,arrow,roar,warn,nor,now,own,raw,row,wan,war
native|native,neat,vent,eat,net,tea,ten,tie,van,via
nature|nature,aunt,earn,near,neat,rate,rent,tear,true,tune,turn,art,ear,eat,era,net,nut,rat,run,tea,ten
nearby|nearby,bare,barn,bean,bear,earn,near,year,any,ban,bar,bay,ear,era
nearly|nearly,early,layer,learn,relay,earn,lane,lean,near,real,rely,year,any,ear,era,lay
needs|dense,need,seed,send,end,see
nelson|lens,lose,none,nose,sole,one,son
nepal|panel,plane,lane,lean,leap,pale,peal,plan,plea,lap,pan,pen
nested|tensed,dense,dent,need,nest,seed,send,teen,tend,end,net,see,set,ten
neural|learn,earn,lane,lean,near,real,rule,ear,era,run
newark|earn,near,rank,wake,wane,warn,weak,wear,ear,era,new,raw,wan,war
newest|sweet,nest,news,sewn,teen,west,net,new,see,set,ten,wet
newman|mane,mean,name,wane,man,new,wan
newton|none,note,tone,town,net,new,not,now,one,owe,own,ten,toe,two,wet
nickel|clink,like,line,link,neck,nice,ice,lie
nicole|coin,icon,line,lion,nice,once,ceo,ice,lie,oil,one
nights|night,sight,thing,hint,shit,sigh,sign,sing,thin,this,his,hit,its,sin,sit
nodes|dose,nose,send,end,nod,one,son
normal|normal,moral,roman,loan,norm,oral,roam,arm,man,nor
norman|roman,norm,roam,arm,man,nor
north|north,horn,torn,hot,nor,not
norton|noon,onto,root,torn,nor,not,too
norway|warn,wary,any,nor,now,own,raw,row,wan,war,way
note|note,tone,net,not,one,ten,toe
noted|dent,note,tend,tone,dot,end,net,nod,not,one,ten,toe
notes|stone,nest,nose,note,tone,net,not,one,set,son,ten,toe
notice|notice,cite,coin,icon,into,nice,note,once,tone,ceo,etc,ice,net,not,one,ten,tie,toe
notion|notion,onion,into,noon,onto,not,too
notre|note,rent,tone,tore,torn,net,nor,not,one,ten,toe
novels|novel,solve,lens,lose,love,nose,oven,sole,one,son
nudist|dust,suit,unit,din,its,nut,sin,sit,sun
number|number,burn,menu,bun,rub,run
nurse|nurse,sure,user,run,sue,sun,use
nurses|nurse,sure,user,run,sue,sun,use
nvidia|avid,aid,and,din,dna,van,via
object|object,bet,ceo,etc,jet,job,toe
obtain|obtain,boat,into,ban,bat,bit,not
often|often,note,tone,net,not,one,ten,toe
oldest|dotes,stole,dose,lose,lost,lots,slot,sole,dot,let,lot,old,set,toe
oliver|liver,lover,evil,live,love,over,role,lie,oil
online|online,line,lion,nine,none,lie,oil,one
opened|deep,need,open,pond,end,nod,one,pen
opens|nose,open,pose,one,pen,son
opera|opera,rape,rope,ear,era,per,pro,rap
optics|topic,cost,post,spit,spot,stop,cop,its,opt,pit,pot,sit,tip,top
option|option,point,into,onto,nip,not,opt,pin,pit,pot,tip,too,top
oracle|clear,care,coal,core,oral,race,real,role,car,ceo,ear,era
orange|orange,anger,organ,range,earn,gear,near,rage,age,ago,ear,ego,era,nor,one
other|other,hero,tore,her,hot,the,toe
others|others,horse,other,shore,short,store,those,hero,hers,host,rest,rose,shoe,shot,sort,tore,her,hot,set,she,the,toe
ought|ought,tough,gut,hot,hug,out,tug
outer|outer,route,tore,tour,true,our,out,toe
output|output,opt,out,pot,put,top
owned|owned,down,end,new,nod,now,one,owe,own,wed
owner|owner,new,nor,now,one,owe,own,row
owners|owner,worse,news,nose,rose,sewn,snow,new,nor,now,one,owe,own,row,son
packed|packed,paced,cake,deck,pace,pack,peak,cap,pad
packet|cake,pace,pack,peak,take,tape,act,apt,cap,cat,eat,etc,pat,pet,tap,tea
pages|gape,gasp,page,age,gap,gas,sea
paint|paint,pain,pant,apt,nip,pan,pat,pin,pit,tap,tip
pairs|pair,rasp,rips,air,rap,rip,sir
palace|palace,place,clap,leap,pace,pale,peal,plea,cap,lap
palmer|ample,realm,lamp,leap,male,meal,pale,palm,peal,plea,rape,real,ream,arm,ear,era,lap,map,per,rap
pamela|ample,lamp,leap,male,meal,pale,palm,peal,plea,lap,map
panel|panel,plane,lane,lean,leap,pale,peal,plan,plea,lap,pan,pen
panels|lapse,panel,plane,lane,lean,leap,lens,pale,peal,plan,plea,sale,seal,slap,snap,lap,pan,pen,sea
panic|panic,pain,can,cap,nip,pan,pin
pants|pant,past,snap,spat,apt,pan,pat,tap
paper|paper,rape,ear,era,per,rap
papers|paper,spare,rape,rasp,ear,era,per,rap,sea
parade|parade,area,dare,dear,rape,read,ear,era,pad,per,rap,red
parcel|clear,place,care,clap,leap,pace,pale,peal,plea,race,rape,real,cap,car,ear,era,lap,per,rap
parent|parent,earn,near,neat,pant,part,prat,rape,rapt,rate,rent,tape,tear,trap,apt,art,ear,eat,era,net,pan,pat,pen,per,pet,rap,rat,tap,tea,ten
paris|pair,rasp,rips,air,rap,rip,sir
parish|parish,sharp,hair,pair,rasp,rips,ship,air,ash,hip,his,rap,rip,sir
parker|park,peak,rape,rare,rear,ear,era,per,rap
part|part,prat,rapt,trap,apt,art,pat,rap,rat,tap
partly|partly,raptly,party,part,play,prat,pray,rapt,trap,tray,apt,art,lap,lay,pat,pay,rap,rat,tap,try
parts|part,past,prat,rapt,rasp,spat,star,trap,apt,art,pat,rap,rat,tap
party|party,part,prat,pray,rapt,trap,tray,apt,art,pat,pay,rap,rat,tap,try
pasta|pasta,past,spat,apt,pat,tap
paste|spate,east,past,seat,spat,step,tape,apt,eat,pat,pet,sea,set,tap,tea
pastor|pastor,sport,atop,part,past,port,post,prat,rapt,rasp,soap,soar,sort,spat,spot,star,stop,trap,apt,art,opt,pat,pot,pro,rap,rat,tap,top
patch|patch,path,act,apt,cap,cat,hat,pat,tap
patent|patent,neat,pant,tape,tent,apt,eat,net,pan,pat,pen,pet,tap,tea,ten
paths|past,path,spat,apt,ash,hat,pat,tap
patio|atop,apt,opt,pat,pit,pot,tap,tip,top
patrol|patrol,atop,oral,part,plot,port,prat,rapt,trap,apt,art,lap,lot,opt,pat,pot,pro,rap,rat,tap,top
paying|gain,pain,any,gap,gay,nip,pan,pay,pig,pin
pearl|leap,pale,peal,plea,rape,real,ear,era,lap,per,rap
peeing|gene,pine,nip,pen,pie,pig,pin
pencil|pencil,clip,line,nice,pile,pine,ice,lie,lip,nip,pen,pie,pin
period|period,pored,pride,roped,dire,drop,prod,ride,rope,die,dip,per,pie,pro,red,rid,rip,rod
permit|permit,merit,prime,item,term,time,tire,trim,trip,per,pet,pie,pit,rim,rip,tie,tip
person|person,prone,nose,open,pose,rope,rose,nor,one,pen,per,pro,son
phase|heaps,phase,shape,ash,sea,she
phases|heaps,phase,shape,pass,sash,ash,ass,sea,she
phone|phone,hope,open,hop,one,pen
phones|phone,shone,hope,nose,open,pose,shoe,shop,hop,one,pen,she,son
photo|photo,hop,hot,opt,pot,too,top
photos|photo,shoot,stoop,host,post,shop,shot,soot,spot,stop,hop,hot,opt,pot,too,top
phrase|phrase,heaps,phase,shape,share,sharp,spare,hear,hers,rape,rasp,ash,ear,era,her,per,rap,sea,she
picked|deck,pick,die,dip,ice,kid,pie
pierce|recipe,piece,price,peer,rice,ice,per,pie,rip
pillow|pillow,pill,poll,will,ill,lip,low,oil
pilot|pilot,plot,lip,lot,oil,opt,pit,pot,tip,top
pitch|pitch,chip,hip,hit,pit,tip
pixels|piles,pile,slip,lie,lip,pie,sex,six
place|place,clap,leap,pace,pale,peal,plea,cap,lap
placed|laced,paced,place,plead,clap,deal,lead,leap,pace,pale,peal,plea,cap,lap,pad
places|lapse,paces,place,scale,space,case,clap,leap,pace,pale,peal,plea,sale,seal,slap,cap,lap,sea
plain|plain,lain,nail,pain,plan,lap,lip,nip,pan,pin
plains|plain,lain,nail,pain,plan,sail,slap,slip,snap,spin,lap,lip,nip,pan,pin,sin
plane|panel,plane,lane,lean,leap,pale,peal,plan,plea,lap,pan,pen
planes|lapse,panel,plane,lane,lean,leap,lens,pale,peal,plan,plea,sale,seal,slap,snap,lap,pan,pen,sea
planet|planet,leapt,panel,plane,plant,plate,lane,late,lean,leap,neat,pale,pant,peal,plan,plea,tale,tape,apt,eat,lap,let,net,pan,pat,pen,pet,tap,tea,ten
plant|plant,pant,plan,apt,lap,pan,pat,tap
plants|plant,last,pant,past,plan,salt,slap,snap,spat,apt,lap,pan,pat,tap
plasma|lamp,palm,slam,slap,lap,map
plate|leapt,plate,late,leap,pale,peal,plea,tale,tape,apt,eat,lap,let,pat,pet,tap,tea
plates|steal,lapse,plate,leapt,least,stale,spate,east,tape,tale,late,leap,step,seal,past,peal,pale,plea,sale,salt,spat,slap,seat,last,tea,sea,pet,pat,apt,let,lap,tap,eat,set
played|delay,plead,deal,lady,lead,leap,pale,peal,play,plea,yelp,day,lap,lay,pad,pay
player|player,early,layer,relay,reply,leap,pale,peal,play,plea,pray,rape,real,rely,year,yelp,ear,era,lap,lay,pay,per,rap
plays|play,slap,lap,lay,pay,say,sly,spy
please|asleep,please,lapse,sleep,ease,else,leap,pale,peal,peel,plea,sale,seal,slap,lap,sea,see
plenty|plenty,type,yelp,let,net,pen,pet,ten,yet
plots|lost,lots,plot,post,slop,slot,spot,stop,lot,opt,pot,top
plugin|gulp,lung,gun,lip,nip,pig,pin
pocket|pocket,cope,poet,poke,ceo,cop,etc,opt,pet,pot,toe,top
poet|poet,opt,pet,pot,toe,top
poetry|poetry,poet,port,rope,tore,type,opt,per,pet,pot,pro,toe,top,toy,try,yet
point|point,into,nip,not,opt,pin,pit,pot,tip,top
points|point,into,post,spin,spit,spot,stop,its,nip,not,opt,pin,pit,pot,sin,sit,son,tip,top
poison|spoon,soon,spin,nip,pin,sin,son
poland|land,load,loan,plan,pond,and,dna,lap,nod,old,pad,pan
police|police,clip,cope,pile,pole,ceo,cop,ice,lie,lip,oil,pie
policy|policy,clip,copy,cop,lip,oil
polish|polish,spoil,ship,shop,slip,slop,soil,hip,his,hop,lip,oil
portal|patrol,atop,oral,part,plot,port,prat,rapt,trap,apt,art,lap,lot,opt,pat,pot,pro,rap,rat,tap,top
porter|report,poet,port,rope,tore,opt,per,pet,pot,pro,toe,top
ports|sport,port,post,sort,spot,stop,opt,pot,pro,top
posing|sign,sing,song,spin,nip,pig,pin,sin,son
post|post,spot,stop,opt,pot,top
postal|also,atop,last,lost,lots,past,plot,post,salt,slap,slop,slot,soap,spat,spot,stop,apt,lap,lot,opt,pat,pot,tap,top
posted|dotes,dose,poet,pose,post,spot,step,stop,dot,opt,pet,pot,set,toe,top
poster|poster,sport,store,poet,port,pose,post,rest,rope,rose,sort,spot,step,stop,tore,opt,per,pet,pot,pro,set,toe,top
posts|post,spot,stop,toss,opt,pot,top
potato|potato,atop,apt,opt,pat,pot,tap,too,top
potter|poet,port,rope,tore,trot,opt,per,pet,pot,pro,toe,top
pounds|pound,sound,pond,soup,spun,upon,nod,son,sun
powder|powder,pored,power,roped,drop,prod,rope,word,owe,per,pro,red,rod,row,wed
power|power,rope,owe,per,pro,row
powers|power,worse,pose,rope,rose,owe,per,pro,row
prague|argue,grape,purge,gape,gear,page,pure,rage,rape,urge,age,ear,era,gap,per,rap
praise|praise,arise,prise,raise,spare,pair,rape,rasp,rips,rise,air,ear,era,per,pie,rap,rip,sea,sir
prayer|prayer,parry,pray,rape,rare,rear,year,ear,era,pay,per,rap
prefer|prefer,refer,free,peer,fee,per
prefix|fire,rife,fix,per,pie,rip
pretty|pretty,type,per,pet,try,yet
price|price,rice,ice,per,pie,rip
priced|price,pride,dire,rice,ride,die,dip,ice,per,pie,red,rid,rip
prices|price,prise,rice,rips,rise,ice,per,pie,rip,sir
pride|pride,dire,ride,die,dip,per,pie,red,rid,rip
priest|priest,stripe,prise,spite,strip,rest,rips,rise,site,spit,step,stir,tire,trip,its,per,pet,pie,pit,rip,set,sir,sit,tie,tip
prince|prince,price,nice,pine,rein,rice,ice,nip,pen,per,pie,pin,rip
print|print,trip,nip,pin,pit,rip,tip
prints|sprint,print,strip,rips,spin,spit,stir,trip,its,nip,pin,pit,rip,sin,sir,sit,tip
prison|prison,iron,rips,spin,nip,nor,pin,pro,rip,sin,sir,son
prizes|prise,prize,rips,rise,size,per,pie,rip,sir
profit|profit,port,riot,trip,fit,for,opt,pit,pot,pro,rip,tip,top
prompt|prompt,port,mop,opt,pop,pot,pro,top
proud|proud,drop,pour,prod,our,pro,rod
proved|pored,prove,roped,roved,drop,over,prod,rope,per,pro,red,rod
proven|prone,prove,open,oven,over,rope,nor,one,pen,per,pro
prozac|crop,cap,car,cop,pro,rap,zap
pubmed|bumped,dumb,dump,bed,due,mud
puerto|erupt,outer,route,poet,port,pour,pure,rope,tore,tour,true,opt,our,out,per,pet,pot,pro,put,toe,top
purse|purse,super,pure,spur,sure,user,per,sue,use
pursue|pursue,purse,super,pure,spur,sure,user,per,sue,use
pushed|push,shed,used,due,hue,she,sue,use
python|hop,hot,not,opt,pot,top,toy
quotes|quest,quote,out,set,sue,toe,use
rabbit|rabbit,air,art,bar,bat,bit,rat,rib
races|scare,care,case,race,car,ear,era,sea
rachel|clear,reach,care,each,heal,hear,race,real,car,ear,era,her
racing|grain,gain,grin,rain,ring,air,can,car
radio|radio,road,aid,air,rid,rod
radios|radio,aids,road,soar,aid,air,rid,rod,sad,sir
radius|aids,aid,air,rid,sad,sir
raise|arise,raise,rise,air,ear,era,sea,sir
raised|arise,aside,raise,aide,aids,dare,dear,dire,idea,read,ride,rise,side,aid,air,die,ear,era,red,rid,sad,sea,sir
raises|arise,raise,rise,air,ass,ear,era,sea,sir
random|random,roman,damn,norm,road,roam,and,arm,dam,dna,mad,man,nod,nor,rod
randy|yard,and,any,day,dna,dry
range|anger,range,earn,gear,near,rage,age,ear,era
ranger|anger,range,earn,gear,near,rage,rare,rear,age,ear,era
ranges|anger,range,earn,gear,near,rage,rags,age,ear,era,gas,sea
ranked|naked,raked,dank,dare,dark,dear,earn,near,rank,read,and,dna,ear,end,era,red
rapid|rapid,pair,aid,air,dip,pad,rap,rid,rip
rapids|rapid,aids,pair,rasp,rips,aid,air,dip,pad,rap,rid,rip,sad,sir
rarely|rarely,early,layer,relay,rare,real,rear,rely,year,ear,era,lay
rate|rate,tear,art,ear,eat,era,rat,tea
rated|trade,dare,dart,date,dear,rate,read,tear,art,ear,eat,era,rat,red,tea
rates|stare,east,rate,rest,seat,star,tear,art,ear,eat,era,rat,sea,set,tea
rather|rather,earth,heart,hate,hear,heat,rare,rate,rear,tear,art,ear,eat,era,hat,her,rat,tea,the
rating|rating,giant,grain,grant,train,gain,gait,grin,rain,ring,air,art,rat,tag
ratios|ratio,stair,riot,soar,sort,star,stir,air,art,its,rat,sir,sit
reach|reach,care,each,hear,race,car,ear,era,her
read|dare,dear,read,ear,era,red
reader|reader,reared,dare,dear,deer,rare,read,rear,ear,era,red
reads|dare,dear,read,ear,era,red,sad,sea
ready|ready,dare,dear,read,yard,year,day,dry,ear,era,red
really|really,alley,early,layer,rally,relay,ally,real,rely,year,yell,all,ear,era,lay
realm|realm,male,meal,real,ream,arm,ear,era
realty|alter,early,later,layer,relay,late,rate,real,rely,tale,tear,tray,year,art,ear,eat,era,lay,let,rat,tea,try,yet
reason|reason,earn,near,nose,rose,soar,ear,era,nor,one,sea,son
rebate|bare,bear,beat,beer,rate,tear,tree,art,bar,bat,bee,bet,ear,eat,era,rat,tea
recall|recall,clear,call,care,cell,race,real,all,car,ear,era
recent|center,centre,recent,enter,rent,teen,tree,etc,net,ten
recipe|recipe,piece,price,peer,rice,ice,per,pie,rip
record|record,order,code,cord,core,ceo,red,rod
reduce|reduce,cure,deer,cue,due,red
refine|finer,fine,fire,free,rein,rife,fee
reform|former,reform,form,from,more,for
refund|under,fund,due,end,fun,fur,red,run
refuse|refuse,free,sure,user,fee,fur,see,sue,use
regard|regard,grade,raged,dare,dear,drag,gear,rage,rare,read,rear,age,ear,era,red
reggae|agree,eager,gear,rage,age,ear,egg,era
region|ignore,region,grin,iron,rein,ring,ego,nor,one
rehab|bare,bear,hear,herb,bar,ear,era,her
relate|relate,alter,elate,later,late,leer,rate,real,tale,tear,tree,art,ear,eat,era,let,rat,tea
relay|early,layer,relay,real,rely,year,ear,era,lay
relief|relief,rifle,feel,file,fire,flee,free,leer,life,rife,fee,lie
reload|dare,deal,dear,lead,load,lord,oral,read,real,road,role,ear,era,old,red,rod
remain|marine,remain,earn,main,mane,mean,mine,name,near,rain,ream,rein,aim,air,arm,ear,era,man,rim
remark|marker,remark,maker,make,mark,rare,ream,rear,arm,ear,era
remedy|reedy,deem,deer,mere,dry,eye,red
remind|remind,dire,mind,mine,rein,ride,die,dim,din,end,red,rid,rim
remote|remote,meter,meet,mere,more,term,tore,tree,toe
remove|remove,ever,mere,more,move,over
rental|rental,alter,later,learn,earn,lane,late,lean,near,neat,rate,real,rent,tale,tear,art,ear,eat,era,let,net,rat,tea,ten
repair|repair,pair,rape,rare,rear,air,ear,era,per,pie,rap,rip
repeat|repeat,part,peer,prat,rape,rapt,rate,tape,tear,trap,tree,apt,art,ear,eat,era,pat,per,pet,rap,rat,tap,tea
report|report,poet,port,rope,tore,opt,per,pet,pot,pro,toe,top
rescue|rescue,secure,cure,sure,user,cue,see,sue,use
resist|resist,sister,rest,rise,site,stir,tire,its,set,sir,sit,tie
resort|resort,store,rest,rose,sort,tore,set,toe
result|result,rustle,rest,rule,sure,true,user,let,set,sue,use
resume|resume,mere,seem,sure,user,mrs,see,sue,sum,use
retail|retail,alter,irate,later,trail,trial,late,rail,rate,real,tail,tale,tear,tile,tire,air,art,ear,eat,era,let,lie,rat,tea,tie
retain|retain,inter,irate,train,earn,near,neat,rain,rate,rein,rent,tear,tire,air,art,ear,eat,era,net,rat,tea,ten,tie
return|return,rent,true,tune,turn,net,nut,run,ten
reveal|reveal,leave,ever,leer,real,ear,era
reward|drawer,reward,dare,dear,draw,rare,read,rear,wear,ear,era,raw,red,war,wed
rider|rider,dire,ride,die,red,rid
riders|rider,dire,ride,rise,side,die,red,rid,sir
rides|dire,ride,rise,side,die,red,rid,sir
ridge|ridge,dire,ride,die,dig,red,rid
riding|rigid,grin,ring,dig,din,rid
rights|rights,right,shirt,sight,shit,sigh,stir,this,his,hit,its,sir,sit
rings|grin,ring,sign,sing,sin,sir
rising|rising,grin,ring,sign,sing,sin,sir
robots|boost,robot,boot,root,soot,sort,too
robust|burst,bout,bust,ours,sort,sour,tour,bus,but,our,out,rub,tub
rocket|rocket,core,rock,tore,ceo,etc,toe
roland|land,load,loan,lord,oral,road,and,dna,nod,nor,old,rod
rolled|doll,lord,role,roll,old,red,rod
roman|roman,norm,roam,arm,man,nor
ronald|land,load,loan,lord,oral,road,and,dna,nod,nor,old,rod
roster|resort,store,rest,rose,sort,tore,set,toe
rotary|roar,tray,art,rat,toy,try
round|round,nod,nor,our,rod,run
rounds|round,sound,ours,sour,nod,nor,our,rod,run,son,sun
route|outer,route,tore,tour,true,our,out,toe
router|outer,route,tore,tour,true,our,out,toe
routes|outer,route,store,ours,rest,rose,sort,sour,sure,tore,tour,true,user,our,out,set,sue,toe,use
ruling|luring,ruling,girl,grin,lung,ring,ruin,gun,run
rwanda|award,drawn,dawn,draw,warn,and,dna,raw,wan,war
sacred|sacred,scared,raced,scare,card,care,case,dare,dear,race,read,car,ear,era,red,sad,sea
safely|safely,false,easy,flay,leaf,safe,sale,seal,self,fly,lay,say,sea,sly,yes
safer|fare,fear,safe,ear,era,far,sea
safety|safety,feast,east,easy,fast,fate,safe,seat,stay,eat,fat,say,sea,set,tea,yes,yet
salem|male,meal,sale,same,seal,slam,sea
sales|sales,less,sale,seal,ass,sea
salmon|salmon,moans,also,loan,slam,man,son
sample|sample,ample,lapse,lamp,leap,male,meal,pale,palm,peal,plea,sale,same,seal,slam,slap,lap,map,sea
samuel|male,meal,sale,same,seal,slam,sea,sue,sum,use
sandy|sand,and,any,day,dna,sad,say
saturn|aunt,star,turn,art,nut,rat,run,sun
sauce|cause,sauce,case,cue,sea,sue,use
saving|saving,gain,sign,sing,gas,sin,van,via
saying|gain,sign,sing,any,gas,gay,say,sin
scales|class,sales,scale,case,less,sale,seal,ass,sea
scared|sacred,scared,raced,scare,card,care,case,dare,dear,race,read,car,ear,era,red,sad,sea
schema|chase,shame,case,cash,each,same,ash,sea,she
scope|copse,scope,cope,pose,ceo,cop
scored|score,code,cord,core,dose,rose,ceo,red,rod
scotia|coast,cast,coat,cost,act,cat,its,sit
script|script,strip,rips,spit,stir,trip,its,pit,rip,sir,sit,tip
sealed|eased,deal,ease,else,lead,sale,seal,seed,sad,sea,see
search|search,chase,crash,reach,scare,share,care,case,cash,each,hear,hers,race,ash,car,ear,era,her,sea,she
season|season,nose,ass,one,sea,son
seat|east,seat,eat,sea,set,tea
seats|asset,east,seat,ass,eat,sea,set,tea
second|second,code,dose,nose,once,send,ceo,end,nod,one,son
secret|secret,steer,rest,tree,etc,see,set
sector|sector,score,store,core,cost,rest,rose,sort,tore,ceo,etc,set,toe
secure|rescue,secure,cure,sure,user,cue,see,sue,use
select|select,elect,steel,else,etc,let,see,set
senate|senate,ease,east,neat,nest,seat,teen,eat,net,sea,see,set,tea,ten
sender|dense,sneer,deer,need,seed,send,end,red,see
senior|senior,noise,iron,nose,rein,rise,rose,nor,one,sin,sir,son
sensor|sensor,snores,nose,rose,nor,one,son
serbia|arise,raise,bare,base,bear,bias,rise,air,bar,ear,era,rib,sea,sir
serial|aisle,arise,laser,raise,rail,real,rise,sail,sale,seal,air,ear,era,lie,sea,sir
serum|sure,user,mrs,sue,sum,use
served|serve,deer,ever,seed,red,see
settle|settle,steel,else,test,let,see,set
setup|upset,step,pet,put,set,sue,use
sewing|swing,news,sewn,sign,sing,swig,wine,wing,wise,new,sin,win
sexual|sexual,sale,seal,sea,sex,sue,use
shade|shade,head,shed,ash,sad,sea,she
shades|shade,head,sash,shed,ash,ass,sad,sea,she
shadow|shadow,show,wash,ash,how,sad,who
shake|shake,sake,ash,ask,sea,she
shape|heaps,phase,shape,ash,sea,she
shaped|heaps,phase,shade,shape,head,shed,ash,pad,sad,sea,she
shapes|heaps,phase,shape,pass,sash,ash,ass,sea,she
share|share,hear,hers,ash,ear,era,her,sea,she
shared|shared,shade,share,shred,dare,dear,hard,head,hear,hers,read,shed,ash,ear,era,her,red,sad,sea,she
shares|share,hear,hers,sash,ash,ass,ear,era,her,sea,she
shaved|shade,have,head,save,shed,ash,sad,sea,she
sheer|sheer,here,hers,her,see,she
sheet|sheet,these,see,set,she,the
sheets|sheet,these,see,set,she,the
shield|sidle,slide,dish,hide,shed,side,slid,die,his,lid,lie,she
shift|shift,fish,fist,shit,this,fit,his,hit,its,sit
shirt|shirt,shit,stir,this,his,hit,its,sir,sit
shirts|shirt,shit,stir,this,his,hit,its,sir,sit
shoot|shoot,host,shot,soot,hot,too
shore|horse,shore,hero,hers,rose,shoe,her,she
shorts|shorts,short,sorts,host,shot,sort,toss,hot
showed|whose,dose,shed,shoe,show,how,owe,she,wed,who
shower|shower,horse,shore,whose,worse,hero,hers,rose,shoe,show,her,how,owe,row,she,who
shown|shown,show,snow,how,now,own,son,who
sierra|arise,raise,rare,rear,rise,air,ear,era,sea,sir
sight|sight,shit,sigh,this,his,hit,its,sit
signal|signal,gain,lain,nail,sail,sign,sing,gas,sin
signed|design,singed,deign,snide,send,side,sign,sing,die,dig,din,end,sin
signup|sign,sing,snug,spin,spun,gun,nip,pig,pin,sin,sun
silent|listen,silent,lens,line,list,nest,site,slit,tile,its,let,lie,net,set,sin,sit,ten,tie
silver|silver,sliver,liver,evil,live,rise,lie,sir
simple|simple,piles,smile,limp,mile,pile,slim,slip,lie,lip,pie
simply|simply,imply,slimy,limp,slim,slip,lip,sly,spy
singer|resign,singer,grin,rein,ring,rise,sign,sing,sin,sir
single|single,lens,line,sign,sing,leg,lie,sin
sister|resist,sister,rest,rise,site,stir,tire,its,set,sir,sit,tie
sixth|sixth,shit,this,his,hit,its,sit,six
skiing|king,sign,sing,sink,skin,sin,ski
skills|skill,kill,kiss,silk,ill,ski
skirt|skirt,risk,stir,its,kit,sir,sit,ski
skirts|skirt,kiss,risk,stir,its,kit,sir,sit,ski
slide|sidle,slide,side,slid,die,lid,lie
slides|sidle,slide,less,side,slid,die,lid,lie
slight|slight,light,sight,list,shit,sigh,slit,this,his,hit,its,sit
slope|slope,lose,pole,pose,slop,sole
slots|loss,lost,lots,slot,toss,lot
smart|smart,star,arm,art,mrs,rat
smith|mist,shit,this,him,his,hit,its,sit
smooth|smooth,shoot,host,most,shot,soot,hot,too
snake|snake,sneak,sake,sank,ask,sea
social|social,also,coal,sail,soil,oil
socket|stock,cost,sock,ceo,etc,set,toe
solely|solely,lose,sell,sole,yell,sly,yes
solid|solid,slid,soil,lid,oil,old
solved|solve,dose,lose,love,sole,old
sorted|strode,dotes,store,dose,rest,rose,sort,tore,trod,dot,red,rod,set,toe
sought|ghost,ought,shout,south,tough,gush,gust,host,shot,shut,thus,gut,hot,hug,out,tug
source|course,source,score,core,cure,ours,rose,sour,sure,user,ceo,cue,our,sue,use
south|shout,south,host,shot,shut,thus,hot,out
soviet|soviet,stove,site,vote,its,set,sit,tie,toe
space|paces,space,case,pace,cap,sea
spaces|paces,space,case,pace,pass,ass,cap,sea
spain|pain,snap,spin,nip,pan,pin,sin
spare|spare,rape,rasp,ear,era,per,rap,sea
speaks|speak,pass,peak,sake,ask,ass,sea
spears|press,rasps,spare,pass,rape,rasp,ass,ear,era,per,rap,sea
spent|nest,step,net,pen,pet,set,ten
sphere|sphere,sheep,sheer,here,hers,peer,her,per,see,she
spider|pride,prise,dire,ride,rips,rise,side,die,dip,per,pie,red,rid,rip,sir
spine|spine,pine,spin,nip,pen,pie,pin,sin
spirit|spirit,strip,rips,spit,stir,trip,its,pit,rip,sir,sit,tip
split|split,list,slip,slit,spit,its,lip,pit,sit,tip
spoken|nose,open,poke,pose,one,pen,son
sport|sport,port,post,sort,spot,stop,opt,pot,pro,top
sports|sorts,sport,port,post,sort,spot,stop,toss,opt,pot,pro,top
spot|post,spot,stop,opt,pot,top
spots|post,spot,stop,toss,opt,pot,top
spray|spray,pray,rasp,pay,rap,say,spy
spread|rasped,spread,spare,dare,dear,rape,rasp,read,ear,era,pad,per,rap,red,sad,sea
spring|spring,grin,grip,ring,rips,sign,sing,spin,nip,pig,pin,rip,sin,sir
sprint|sprint,print,strip,rips,spin,spit,stir,trip,its,nip,pin,pit,rip,sin,sir,sit,tip
square|square,sure,user,ear,era,sea,sue,use
squirt|squirt,quit,stir,suit,its,sir,sit
stable|stable,beast,blast,bleat,least,stale,steal,table,able,base,beat,belt,best,east,last,late,sale,salt,seal,seat,tale,bat,bet,eat,lab,let,sea,set,tea
stack|stack,cast,sack,task,act,ask,cat
stage|stage,east,gate,seat,age,eat,gas,get,sea,set,tag,tea
stages|asset,stage,east,gate,seat,age,ass,eat,gas,get,sea,set,tag,tea
stake|stake,steak,east,sake,seat,take,task,ask,eat,sea,set,tea
stamp|stamp,past,spat,apt,map,pat,tap
stamps|spasm,stamp,mass,pass,past,spat,apt,ass,map,pat,tap
stands|stand,sand,and,ass,dna,sad
state|state,taste,east,seat,test,eat,sea,set,tea
stated|state,taste,date,east,seat,test,eat,sad,sea,set,tea
states|asset,state,taste,east,seat,test,ass,eat,sea,set,tea
stayed|steady,date,east,easy,seat,stay,day,eat,sad,say,sea,set,tea,yes,yet
steady|steady,date,east,easy,seat,stay,day,eat,sad,say,sea,set,tea,yes,yet
steal|least,stale,steal,east,last,late,sale,salt,seal,seat,tale,eat,let,sea,set,tea
steam|steam,east,mate,meat,same,seat,stem,team,eat,sea,set,tea
stereo|steer,store,rest,rose,sort,tore,tree,see,set,toe
steven|event,seven,even,nest,teen,vent,net,see,set,ten
stick|stick,sick,its,kit,sit,ski
sticks|stick,kiss,sick,its,kit,sit,ski
sticky|sticky,stick,city,sick,its,kit,sit,ski,sky
still|still,list,slit,till,ill,its,sit
stolen|stole,stone,lens,lose,lost,lots,nest,nose,note,slot,sole,tone,let,lot,net,not,one,set,son,ten,toe
stone|stone,nest,nose,note,tone,net,not,one,set,son,ten,toe
stones|stone,nest,nose,note,tone,toss,net,not,one,set,son,ten,toe
stop|post,spot,stop,opt,pot,top
stops|post,spot,stop,toss,opt,pot,top
store|store,rest,rose,sort,tore,set,toe
stored|strode,dotes,store,dose,rest,rose,sort,tore,trod,dot,red,rod,set,toe
stores|sorts,store,rest,rose,sort,tore,toss,set,toe
strain|strain,stair,train,rain,star,stir,air,art,its,rat,sin,sir,sit
strand|stand,dart,sand,star,and,art,dna,rat,sad
strap|part,past,prat,rapt,rasp,spat,star,trap,apt,art,pat,rap,rat,tap
stream|master,stream,smart,stare,steam,terms,east,mate,meat,rate,ream,rest,same,seat,star,stem,team,tear,term,arm,art,ear,eat,era,mrs,rat,sea,set,tea
street|street,steer,rest,test,tree,see,set
strike|strike,skirt,rest,rise,risk,site,stir,tire,its,kit,set,sir,sit,ski,tie
string|string,grin,ring,sign,sing,stir,its,sin,sir,sit
strip|strip,rips,spit,stir,trip,its,pit,rip,sir,sit,tip
strips|strip,rips,spit,stir,trip,its,pit,rip,sir,sit,tip
stroke|stroke,store,rest,rose,sort,tore,set,toe
strong|strong,snort,song,sort,torn,nor,not,son
stuart|start,trust,star,taut,art,rat
studio|studio,dust,suit,dot,its,out,sit
stupid|stupid,dust,spit,suit,dip,its,pit,put,sit,tip
style|style,let,set,sly,yes,yet
styles|style,less,let,set,sly,yes,yet
submit|submit,bust,mist,must,suit,bit,bus,but,its,sit,sum,tub
subtle|bustle,subtle,belt,best,blue,bust,tube,bet,bus,but,let,set,sue,tub,use
sudden|sudden,send,used,due,end,sue,sun,use
suffer|suffer,ruffs,ruff,sure,user,fur,sue,use
suite|suite,site,suit,its,set,sit,sue,tie,use
suited|suite,diet,dust,edit,side,site,suit,tide,used,die,due,its,set,sit,sue,tie,use
suites|tissue,issue,suite,site,suit,its,set,sit,sue,tie,use
summer|summer,sure,user,mrs,mum,sue,sum,use
summit|summit,mist,must,suit,its,mum,sit,sum
sunday|sunday,sand,and,any,day,dna,sad,say,sun
sunset|nest,tune,net,nut,set,sue,sun,ten,use
super|purse,super,pure,spur,sure,user,per,sue,use
superb|purse,super,pure,spur,sure,user,bus,per,rub,sue,use
surely|surely,surly,rely,rule,sure,user,sly,sue,use,yes
survey|survey,sure,user,very,sue,use,yes
sweden|dense,need,news,seed,send,sewn,weed,end,new,see,wed
swing|swing,sign,sing,swig,wing,sin,win
switch|switch,shit,this,wish,with,his,hit,its,sit
system|system,mess,stem,set,yes,yet
table|bleat,table,able,beat,belt,late,tale,bat,bet,eat,lab,let,tea
tables|stable,beast,blast,bleat,least,stale,steal,table,able,base,beat,belt,best,east,last,late,sale,salt,seal,seat,tale,bat,bet,eat,lab,let,sea,set,tea
tablet|battle,bleat,table,able,beat,belt,late,tale,bat,bet,eat,lab,let,tea
tackle|tackle,cake,lack,lake,late,take,tale,talk,act,cat,eat,etc,let,tea
tagged|date,gate,age,eat,egg,get,tag,tea
tahoe|hate,heat,eat,hat,hot,tea,the,toe
taiwan|await,twin,wait,want,wan,win
taken|neat,take,tank,eat,net,tea,ten
takes|stake,steak,east,sake,seat,take,task,ask,eat,sea,set,tea
taking|giant,gain,gait,king,knit,tank,kit,tag
talent|talent,lane,late,lean,neat,tale,tent,eat,let,net,tea,ten
tales|least,stale,steal,east,last,late,sale,salt,seal,seat,tale,eat,let,sea,set,tea
talked|date,deal,lake,late,lead,take,tale,talk,eat,let,tea
tape|tape,apt,eat,pat,pet,tap,tea
tapes|spate,east,past,seat,spat,step,tape,apt,eat,pat,pet,sea,set,tap,tea
target|target,grate,great,treat,gate,gear,rage,rate,tear,age,art,ear,eat,era,get,rat,tag,tea
tariff|fair,air,art,far,fat,fit,rat
taste|state,taste,east,seat,test,eat,sea,set,tea
taught|taut,that,gut,hat,hug,tag,tug
taxes|east,seat,eat,sea,set,sex,tax,tea
taylor|royal,oral,tray,art,lay,lot,rat,toy,try
teach|cheat,teach,each,hate,heat,act,cat,eat,etc,hat,tea,the
teams|steam,east,mate,meat,same,seat,stem,team,eat,sea,set,tea
tear|rate,tear,art,ear,eat,era,rat,tea
tears|stare,east,rate,rest,seat,star,tear,art,ear,eat,era,rat,sea,set,tea
techno|echo,note,once,then,tone,ceo,etc,hot,net,not,one,ten,the,toe
teens|nest,teen,net,see,set,ten
temple|temple,meet,melt,peel,let,pet
tenant|neat,tent,eat,net,tea,ten
tender|tender,enter,trend,deer,dent,need,rent,teen,tend,tree,end,net,red,ten
tennis|tennis,nest,nine,site,its,net,set,sin,sit,ten,tie
terms|terms,rest,stem,term,mrs,set
texas|east,seat,eat,sea,set,sex,tax,tea
thanks|thanks,thank,sank,tank,task,than,ash,ask,hat
thehun|hunt,then,tune,hue,huh,net,nut,ten,the
their|their,hire,tire,her,hit,the,tie
themes|sheet,theme,these,meet,seem,stem,them,see,set,she,the
theory|theory,other,hero,they,tore,her,hey,hot,the,toe,toy,try,yet
there|there,three,here,tree,her,the
these|sheet,these,see,set,she,the
thesis|shit,site,this,his,hit,its,set,she,sit,the,tie
theta|hate,heat,that,eat,hat,tea,the
things|night,sight,thing,hint,shit,sigh,sign,sing,thin,this,his,hit,its,sin,sit
think|think,hint,knit,thin,hit,kit
thinks|think,hint,knit,shit,sink,skin,thin,this,his,hit,its,kit,sin,sit,ski
this|shit,this,his,hit,its,sit
thomas|host,math,most,shot,ash,hat,hot
thongs|ghost,host,shot,song,hot,not,son
those|those,host,shoe,shot,hot,set,she,the,toe
though|though,ought,tough,gut,hot,hug,huh,out,tug
thread|thread,death,earth,heart,trade,dare,dart,date,dear,hard,hate,head,hear,heat,rate,read,tear,art,ear,eat,era,hat,her,rat,red,tea,the
threat|threat,earth,heart,treat,hate,hear,heat,rate,tear,that,art,ear,eat,era,hat,her,rat,tea,the
three|there,three,here,tree,her,the
throat|throat,that,trot,art,hat,hot,rat
throw|throw,worth,hot,how,row,two,who
thrown|thrown,north,throw,worth,horn,torn,town,hot,how,nor,not,now,own,row,two,who
throws|short,throw,worth,host,shot,show,sort,stow,hot,how,row,two,who
thumbs|thumb,bush,bust,must,shut,thus,bus,but,sum,tub
ticket|ticket,cite,etc,ice,kit,tie
tigers|rest,rise,site,stir,tire,get,its,set,sir,sit,tie
tiles|list,site,slit,tile,its,let,lie,set,sit,tie
timber|timber,merit,tribe,bite,item,term,time,tire,trim,bet,bit,rib,rim,tie
timely|timely,item,melt,mile,tile,time,let,lie,tie,yet
timer|merit,item,term,time,tire,trim,rim,tie
times|item,mist,site,stem,time,its,set,sit,tie
tions|into,its,not,sin,sit,son
tired|tired,diet,dire,dirt,edit,ride,tide,tire,die,red,rid,tie
tires|rest,rise,site,stir,tire,its,set,sir,sit,tie
tissue|tissue,issue,suite,site,suit,its,set,sit,sue,tie,use
titled|tilted,title,diet,edit,tide,tile,die,let,lid,lie,tie
titles|title,list,site,slit,test,tile,its,let,lie,set,sit,tie
tobago|boat,boot,goat,ago,bag,bat,tag,too
toilet|toilet,title,tile,let,lie,lot,oil,tie,toe
token|note,tone,net,not,one,ten,toe
tone|note,tone,net,not,one,ten,toe
toner|note,rent,tone,tore,torn,net,nor,not,one,ten,toe
tones|stone,nest,nose,note,tone,net,not,one,set,son,ten,toe
tongue|tongue,note,tone,tune,ego,get,gun,gut,net,not,nut,one,out,ten,toe,tug
tools|lost,lots,slot,soot,tool,lot,too
topic|topic,cop,opt,pit,pot,tip,top
topics|topic,cost,post,spit,spot,stop,cop,its,opt,pit,pot,sit,tip,top
tops|post,spot,stop,opt,pot,top
totals|total,also,last,lost,lots,salt,slot,lot
tough|ought,tough,gut,hot,hug,out,tug
tours|ours,sort,sour,tour,our,out
toward|toward,dart,draw,road,trod,word,art,dot,rat,raw,rod,row,two,war
tower|tower,tore,owe,row,toe,two,wet
towers|store,tower,worse,rest,rose,sort,stow,tore,west,owe,row,set,toe,two,wet
towns|snow,stow,town,not,now,own,son,two
trace|react,trace,care,cart,race,rate,tear,act,art,car,cat,ear,eat,era,etc,rat,tea
track|track,cart,rack,act,art,car,cat,rat
tracks|stack,stark,track,cart,cast,rack,sack,star,task,act,art,ask,car,cat,rat
tract|cart,act,art,car,cat,rat
tracy|cart,tray,act,art,car,cat,cry,rat,try
trade|trade,dare,dart,date,dear,rate,read,tear,art,ear,eat,era,rat,red,tea
trader|tarred,trade,dare,dart,date,dear,rare,rate,read,rear,tear,art,ear,eat,era,rat,red,tea
trades|stare,trade,dare,dart,date,dear,east,rate,read,rest,seat,star,tear,art,ear,eat,era,rat,red,sad,sea,set,tea
trail|trail,trial,rail,tail,air,art,rat
trails|stair,trail,trial,last,list,rail,sail,salt,slit,star,stir,tail,air,art,its,rat,sir,sit
trains|strain,stair,train,rain,star,stir,air,art,its,rat,sin,sir,sit
trance|crane,enact,react,trace,care,cart,earn,near,neat,race,rate,rent,tear,act,art,can,car,cat,ear,eat,era,etc,net,rat,tea,ten
trap|part,prat,rapt,trap,apt,art,pat,rap,rat,tap
trash|trash,star,art,ash,hat,rat
travel|travel,alter,later,late,rate,real,tale,tear,art,ear,eat,era,let,rat,tea
travis|stair,star,stir,vast,air,art,its,rat,sir,sit,via
treat|treat,rate,tear,art,ear,eat,era,rat,tea
treaty|treaty,treat,rate,tear,tray,year,art,ear,eat,era,rat,tea,try,yet
trend|trend,dent,rent,tend,end,net,red,ten
trends|stern,trend,dent,nest,rent,rest,send,tend,end,net,red,set,ten
trial|trail,trial,rail,tail,air,art,rat
trials|stair,trail,trial,last,list,rail,sail,salt,slit,star,stir,tail,air,art,its,rat,sir,sit
tribal|tribal,trail,trial,rail,tail,air,art,bar,bat,bit,lab,rat,rib
tribe|tribe,bite,tire,bet,bit,rib,tie
tribes|tribe,best,bite,rest,rise,site,stir,tire,bet,bit,its,rib,set,sir,sit,tie
tricks|skirt,stick,trick,risk,sick,stir,its,kit,sir,sit,ski
tried|tired,diet,dire,dirt,edit,ride,tide,tire,die,red,rid,tie
tries|rest,rise,site,stir,tire,its,set,sir,sit,tie
triple|pile,tile,tire,trip,let,lie,lip,per,pet,pie,pit,rip,tie,tip
trips|strip,rips,spit,stir,trip,its,pit,rip,sir,sit,tip
troops|sport,stoop,troop,poor,port,post,root,soot,sort,spot,stop,opt,pot,pro,too,top
tubes|best,bust,tube,bet,bus,but,set,sue,tub,use
tucson|count,cost,cut,not,nut,out,son,sun
tuner|rent,true,tune,turn,net,nut,run,ten
tunes|nest,tune,net,nut,set,sue,sun,ten,use
tunnel|tunnel,tune,let,net,nut,ten
turbo|bout,tour,but,our,out,rub,tub
turkey|turkey,true,tyke,key,try,yet
turned|trend,under,dent,rent,tend,true,tune,turn,due,end,net,nut,red,run,ten
turner|return,rent,true,tune,turn,net,nut,run,ten
twenty|twenty,tent,net,new,ten,wet,yet
twice|twice,cite,etc,ice,tie,wet
twinks|knit,sink,skin,twin,its,kit,sin,sit,ski,win
types|step,type,pet,set,spy,yes,yet
typing|tiny,nip,pig,pin,pit,tip
unable|unable,able,bean,blue,lane,lean,ban,bun,lab
united|united,unite,dent,diet,edit,tend,tide,tune,unit,die,din,due,end,net,nut,ten,tie
units|suit,unit,its,nut,sin,sit,sun
unless|unless,lens,less,sue,sun,use
unwrap|warn,wrap,pan,rap,raw,run,wan,war
update|update,taped,date,tape,apt,due,eat,pad,pat,pet,put,tap,tea
upset|upset,step,pet,put,set,sue,use
urban|urban,barn,burn,ban,bar,bun,rub,run
urgent|grunt,rent,true,tune,turn,urge,get,gun,gut,net,nut,run,ten,tug
using|sign,sing,snug,gun,sin,sun
valley|valley,alley,ally,yell,all,lay
values|slave,value,sale,save,seal,sea,sue,use
varied|drive,aide,avid,dare,dear,dire,idea,read,ride,vied,aid,air,die,ear,era,red,rid,via
varies|arise,raise,rise,save,air,ear,era,sea,sir,via
vector|covert,cover,overt,trove,voter,core,over,tore,vote,ceo,etc,toe
vendor|vendor,drone,roved,oven,over,end,nod,nor,one,red,rod
venues|seven,even,see,sue,sun,use
verbal|verbal,brave,able,bare,bear,real,bar,ear,era,lab
viewed|vied,view,weed,wide,die,wed
voters|overt,store,stove,trove,voter,over,rest,rose,sort,tore,vote,set,toe
wagner|anger,range,earn,gear,gnaw,near,rage,wage,wane,warn,wear,age,ear,era,new,raw,wan,war
wagon|wagon,gnaw,ago,now,own,wan
waiver|waver,view,wave,wear,wire,air,ear,era,raw,via,war
walked|deal,lake,lead,wake,walk,weak,weal,law,wed
walker|lake,real,wake,walk,weak,weal,wear,ear,era,law,raw,war
wallet|late,tale,tall,tell,wall,weal,well,all,eat,law,let,tea,wet
walnut|aunt,lawn,want,law,nut,wan
walter|alter,later,water,late,rate,real,tale,tear,weal,wear,art,ear,eat,era,law,let,rat,raw,tea,war,wet
wanted|date,dawn,dent,neat,tend,wane,want,and,dna,eat,end,net,new,tea,ten,wan,wed,wet
warned|wander,drawn,dare,dawn,dear,draw,earn,near,read,wane,warn,wear,and,dna,ear,end,era,new,raw,red,wan,war,wed
warner|earn,near,rare,rear,wane,warn,wear,ear,era,new,raw,wan,war
warren|earn,near,rare,rear,wane,warn,wear,ear,era,new,raw,wan,war
washer|share,swear,hear,hers,wash,wear,ash,ear,era,her,raw,sea,she,war
waste|sweat,waste,east,seat,west,eat,sea,set,tea,wet
water|water,rate,tear,wear,art,ear,eat,era,rat,raw,tea,war,wet
waters|stare,straw,swear,sweat,waste,water,east,rate,rest,seat,star,tear,wear,west,art,ear,eat,era,rat,raw,sea,set,tea,war,wet
watson|snow,stow,town,want,not,now,own,son,two,wan
wealth|wealth,whale,wheat,halt,hate,heal,heat,late,tale,weal,what,eat,hat,law,let,tea,the,wet
weapon|weapon,open,wane,new,now,one,owe,own,pan,pen,wan
weblog|below,elbow,globe,blew,blow,bowl,glow,beg,bow,ego,leg,log,low,owe,web
weight|weight,eight,weigh,white,with,get,hit,the,tie,wet
weird|weird,dire,ride,wide,wire,die,red,rid,wed
wheat|wheat,hate,heat,what,eat,hat,tea,the,wet
whilst|list,shit,slit,this,wilt,wish,with,his,hit,its,sit
white|white,with,hit,the,tie,wet
whole|whole,hole,howl,how,low,owe,who
whose|whose,shoe,show,how,owe,she,who
wicked|wicked,deck,wide,die,ice,kid,wed
widely|widely,yield,wide,wild,die,lid,lie,wed
wider|weird,dire,ride,wide,wire,die,red,rid,wed
wilson|lion,slow,snow,soil,low,now,oil,own,sin,son,win
window|window,widow,down,wind,din,nod,now,own,win,wow
wines|news,sewn,wine,wise,new,sin,win
wings|swing,sign,sing,swig,wing,sin,win
winner|winner,inner,nine,rein,wine,wire,new,win
winter|winter,inter,write,rein,rent,tire,twin,wine,wire,net,new,ten,tie,wet,win
wired|weird,dire,ride,wide,wire,die,red,rid,wed
within|within,hint,thin,twin,with,hit,win
wizard|draw,aid,air,raw,rid,war
womens|news,nose,sewn,snow,some,new,now,one,owe,own,son
wonder|wonder,drone,drown,owned,owner,down,word,end,new,nod,nor,now,one,owe,own,red,rod,row,wed
wooden|wooden,owned,down,wood,end,new,nod,now,one,owe,own,wed
worked|word,work,owe,red,rod,row,wed
world|world,lord,word,low,old,rod,row
worlds|sword,world,lord,slow,word,low,old,rod,row
worth|throw,worth,hot,how,row,two,who
worthy|throw,worth,hot,how,row,toy,try,two,who,why
writer|writer,write,tire,wire,tie,wet
writes|wrist,write,rest,rise,site,stir,tire,west,wire,wise,its,set,sir,sit,tie,wet
wrong|wrong,grow,nor,now,own,row
wrote|tower,tore,owe,row,toe,two,wet
yearly|early,layer,relay,real,rely,year,ear,era,lay
years|easy,year,ear,era,say,sea,yes
yeast|east,easy,seat,stay,eat,say,sea,set,tea,yes,yet
yields|yields,sidle,slide,yield,side,slid,die,lid,lie,sly,yes
yours|yours,ours,sour,your,our,you